    940 to	v.
    297 a	n.
    190 the	n.
    137 to	n.
     62 a	v.
     47 to make	ad.
     46 the	v.
     46 the	ad.
     30 to	ad.
     27 an	n.
     25 having	ad.
     22 of	conj.
     20 such	conj.
     17 a person	pro.
     16 something	ad.
     16 of or	adj.
     16 any	n.
     15 a group	prep.
     13 a small	n.
     13 a large	n.
     12 usually	prep.
     12 having	pro.
     11 used	prep.
     11 to take	n.
     11 to make a	n.
     11 something	pro.
     11 having the	n.
     10 the act	prep.
     10 at	pro.
     10 at	ad.
     10 a place	prep.
     10 an	v.
      9 to give	n.
      9 the condition	prep.
      9 one	prep.
      9 not	prep.
      9 in	pro.
      9 in	ad.
      9 having the color	v.
      9 having the color	ad.
      8 to say	ad.
      8 to put	ad.
      8 to not	v.
      8 to be	ad.
      8 the part	prep.
      8 one	pro.
      8 of	ad.
      8 i	v.
      8 anything	pro.
      8 anything	ad.
      8 all	pro.
      7 usually	ad.
      7 to go	ad.
      7 having the color like that	prep.
      6 we	v.
      6 to make	n.
      6 to give	ad.
      6 to become	ad.
      6 the part of	ad.
      6 such as	n.
      6 not	v.
      6 more	conj.
      6 extremely	ad.
      5 with	ad.
      5 used to	v.
      5 to take	conj.
      5 to move	conj.
      5 to have	n.
      5 to have	ad.
      5 to get	ad.
      5 to come	ad.
      5 to cause	ad.
      5 the scientific	v.
      5 the scientific study	prep.
      5 the direction	prep.
      5 such as a	n.
      5 place	conj.
      5 opposite	v.
      5 of	pro.
      5 of or about	pro.
      5 of or about	ad.
      5 in the	n.
      5 having	n.
      5 as	ad.
      5 a person	prep.
      5 a period	prep.
      5 a part	prep.
      5 a device	pro.
      4 what	n.
      4 usually made	prep.
      4 to take	ad.
      4 to say	pro.
      4 to make an	n.
      4 to keep	conj.
      4 to have	pro.
      4 to give	conj.
      4 to give a	n.
      4 to form	ad.
      4 to force	ad.
      4 to	conj.
      4 to come	conj.
      4 they	v.
      4 the use	prep.
      4 the amount	prep.
      4 the ability to	v.
      4 the ability	prep.
      4 size	conj.
      4 opposite	n.
      4 one of	pro.
      4 of or about the	n.
      4 not	n.
      4 in	conj.
      4 he	ad.
      4 free	prep.
      4 especially	prep.
      4 especially	conj.
      4 but	pro.
      4 a very small	n.
      4 at the	n.
      4 a strong	n.
      4 a piece	prep.
      4 a person	conj.
      4 a number	prep.
      4 and	ad.
      4 a measure	prep.
      4 a device	prep.
      3 usually	n.
      3 usually made of	n.
      3 to use	n.
      3 to use	ad.
      3 to talk	adj.
      3 to take part in	ad.
      3 to show	pro.
      3 to show	ad.
      3 to send	ad.
      3 to seize	conj.
      3 to put	conj.
      3 to move	ad.
      3 to make	conj.
      3 to know	conj.
      3 to go	conj.
      3 to give	pro.
      3 to get	conj.
      3 to decide	ad.
      3 to control	conj.
      3 to change	n.
      3 to cause	conj.
      3 to become	n.
      3 to act	conj.
      3 the use of	n.
      3 the time	prep.
      3 the talks	v.
      3 the system	prep.
      3 the study	prep.
      3 the person	conj.
      3 the form	prep.
      3 the condition of being	ad.
      3 the complete	n.
      3 that	n.
      3 showing the	n.
      3 showing	pro.
      3 ready	prep.
      3 one of	ad.
      3 one	ad.
      3 of the	ad.
      3 often	prep.
      3 often	conj.
      3 of or about	n.
      3 of great	n.
      3 not able	prep.
      3 needing	ad.
      3 in	v.
      3 he is	ad.
      3 having or feeling	ad.
      3 having much	n.
      3 having	conj.
      3 having a	n.
      3 from	n.
      3 for	pro.
      3 for	ad.
      3 especially	pro.
      3 a word used	prep.
      3 a word	conj.
      3 a vehicle	prep.
      3 at the	ad.
      3 a thin piece	prep.
      3 a thin	n.
      3 as	prep.
      3 a small piece	prep.
      3 a public	n.
      3 a person's	n.
      3 any substance	pro.
      3 any	prep.
      3 any of	pro.
      3 a material made	prep.
      3 a mass	prep.
      3 a long	n.
      3 a large area	prep.
      3 a lack	prep.
      3 a kind	prep.
      3 a form	prep.
      3 a farm animal used	prep.
      3 about	conj.
      3 able	prep.
      2 you	v.
      2 words	conj.
      2 without	v.
      2 without	n.
      2 which	n.
      2 what people	v.
      2 what is	n.
      2 we	n.
      2 weight or	n.
      2 weight	conj.
      2 water	conj.
      2 usually	conj.
      2 usually a	n.
      2 used with	ad.
      2 used to ask	adj.
      2 used in	n.
      2 used	conj.
      2 used	ad.
      2 until the	n.
      2 until	pro.
      2 town	conj.
      2 to travel in	ad.
      2 to travel	conj.
      2 to travel by	n.
      2 to think	adj.
      2 to tell	adj.
      2 to take as	ad.
      2 to speak	ad.
      2 to separate into two	conj.
      2 to sense through	pro.
      2 to seize	ad.
      2 to say something	conj.
      2 to say a	n.
      2 to return to	ad.
      2 to remove from	n.
      2 to receive	n.
      2 to put into the	n.
      2 to put into	pro.
      2 to put in	n.
      2 to put an	n.
      2 to promise	ad.
      2 to produce	ad.
      2 to	pro.
      2 to prevent	n.
      2 to present	conj.
      2 to praise a	n.
      2 to praise	ad.
      2 to plan	conj.
      2 to organize	conj.
      2 to no longer	v.
      2 to move or	n.
      2 to move like a	n.
      2 to leave a	n.
      2 to leave	ad.
      2 to join	ad.
      2 to hold	ad.
      2 to have the	n.
      2 to have the	ad.
      2 to have power	conj.
      2 to have one's	n.
      2 to have	conj.
      2 to go from one	n.
      2 to form an opinion	adj.
      2 to feel	ad.
      2 to express	n.
      2 to express	conj.
      2 to express	ad.
      2 to divide	conj.
      2 to declare	pro.
      2 to decide a	n.
      2 to damage	conj.
      2 to buy	conj.
      2 to bring	conj.
      2 to break	ad.
      2 to be on	n.
      2 to believe	ad.
      2 to be employed	conj.
      2 to become a	n.
      2 this	n.
      2 thin	n.
      2 they were	ad.
      2 the written	n.
      2 the work	ad.
      2 the way	prep.
      2 the time of the year	ad.
      2 the time	ad.
      2 the study of	n.
      2 the smallest	n.
      2 the sex	ad.
      2 the scientific study of	n.
      2 the rate	prep.
      2 the quality	prep.
      2 the part of a	v.
      2 the part	ad.
      2 the organization	prep.
      2 the organization of	n.
      2 the movement	prep.
      2 the middle	prep.
      2 the house	prep.
      2 the highest	n.
      2 the direction to the	ad.
      2 the condition of being	v.
      2 the chief official	prep.
      2 the bottom part	prep.
      2 the bottom	n.
      2 that which	n.
      2 strength	conj.
      2 stories	conj.
      2 something that happens	conj.
      2 something that happens by	n.
      2 something	prep.
      2 something done	conj.
      2 someone	pro.
      2 someone	conj.
      2 situation	conj.
      2 similar	prep.
      2 showing	ad.
      2 she is	ad.
      2 round	n.
      2 ready to	v.
      2 place or thing being spoken	adj.
      2 pieces	prep.
      2 pieces of	n.
      2 part	prep.
      2 or	prep.
      2 or	n.
      2 or	ad.
      2 on the side	ad.
      2 on the	n.
      2 on	pro.
      2 on	n.
      2 one's	n.
      2 one or	ad.
      2 one of a	n.
      2 one	n.
      2 one	conj.
      2 of the	n.
      2 of or having	ad.
      2 of	n.
      2 newspaper or	n.
      2 newspaper	conj.
      2 more than	n.
      2 money	conj.
      2 members	prep.
      2 members of	pro.
      2 made	prep.
      2 like	n.
      2 like a	n.
      2 lasting	ad.
      2 known	ad.
      2 in the	ad.
      2 in	n.
      2 information gathered	conj.
      2 in atomic	n.
      2 in a	n.
      2 her	n.
      2 he left	prep.
      2 having the color like that made	conj.
      2 having little or no	n.
      2 having little	conj.
      2 great	prep.
      2 great in	n.
      2 giving	ad.
      2 for the	n.
      2 for	n.
      2 feeling	n.
      2 feeling	ad.
      2 even	conj.
      2 especially the	n.
      2 energy	prep.
      2 either the	n.
      2 either	pro.
      2 easy to	v.
      2 easy	prep.
      2 damaged	conj.
      2 damage	conj.
      2 completely	ad.
      2 close	prep.
      2 city	conj.
      2 causing	v.
      2 causing	n.
      2 causing	ad.
      2 but	ad.
      2 bought	conj.
      2 between	n.
      2 below the	n.
      2 below	pro.
      2 belonging	prep.
      2 being	pro.
      2 before	ad.
      2 a young	n.
      2 a word used with an action word to	v.
      2 a woman	pro.
      2 away	prep.
      2 a vehicle with wheels used to	v.
      2 at this	n.
      2 at the same	n.
      2 at or	ad.
      2 a tool	conj.
      2 at	conj.
      2 at any	n.
      2 at a	n.
      2 a substance	pro.
      2 a statement	prep.
      2 a statement in	pro.
      2 a special	n.
      2 as	n.
      2 a small part	prep.
      2 a small animal that often lives	prep.
      2 a small animal	pro.
      2 as is	ad.
      2 a short	n.
      2 a share	prep.
      2 a series	prep.
      2 as a	n.
      2 a room	conj.
      2 a road	prep.
      2 a play	conj.
      2 a plan	prep.
      2 a place	conj.
      2 a picture	prep.
      2 a person in	pro.
      2 a part of	pro.
      2 any	v.
      2 anything that	v.
      2 anything that	n.
      2 anything	prep.
      2 any group	prep.
      2 a number of people	conj.
      2 an organization	pro.
      2 an opening	prep.
      2 an important	n.
      2 animal	conj.
      2 and	pro.
      2 and	n.
      2 an attempt	prep.
      2 an amount	prep.
      2 amount	conj.
      2 a method	prep.
      2 a man	pro.
      2 a machine	pro.
      2 all	prep.
      2 all	conj.
      2 a living	n.
      2 a large amount	prep.
      2 a job	pro.
      2 a high	n.
      2 a heavy	n.
      2 a hard	n.
      2 a group of people	conj.
      2 a form of energy	pro.
      2 a flat	n.
      2 a feeling	prep.
      2 a drink made	prep.
      2 a drink made from the	n.
      2 a drink made from	pro.
      2 a device used to	v.
      2 a device used	prep.
      2 activity	conj.
      2 action	n.
      2 a creature	pro.
      2 a continuing	v.
      2 a collection	prep.
      2 a building	prep.
      2 about or having to	v.
      2 about or having	prep.
      1 you need technical	n.
      1 you need technical knowledge	prep.
      1 you need	ad.
      1 you must go to	n.
      1 you must go	prep.
      1 yet	pro.
      1 yellow	conj.
      1 written or spoken	n.
      1 written	conj.
      1 writing	conj.
      1 workers	conj.
      1 workers as a	n.
      1 workers as	ad.
      1 work done	prep.
      1 words and their	v.
      1 words and their sounds organized	prep.
      1 words and their sounds organized in a special way to	v.
      1 words and their sounds organized in a special	n.
      1 words and their sounds organized in	ad.
      1 wood	conj.
      1 woman	conj.
      1 with the	v.
      1 with the	n.
      1 with	pro.
      1 with little or no	n.
      1 with little	conj.
      1 with good reason to	v.
      1 with good	n.
      1 with another to	v.
      1 with another to make	pro.
      1 willing to	v.
      1 willing to serve or	n.
      1 willing to serve	conj.
      1 willing	prep.
      1 wide	conj.
      1 why did she	v.
      1 why did	pro.
      1 who wants	prep.
      1 white pieces	prep.
      1 white pieces of frozen water that	v.
      1 white pieces of frozen water	pro.
      1 white pieces of frozen	n.
      1 which	v.
      1 which program	v.
      1 which program do you	ad.
      1 which or which	n.
      1 which or which	ad.
      1 which	conj.
      1 where trials	v.
      1 where trials take	n.
      1 where someone or something came	prep.
      1 where someone	conj.
      1 where judges	v.
      1 where judges make decisions	adj.
      1 where judges make decisions about	n.
      1 when will	pro.
      1 when	v.
      1 when there is little or no	n.
      1 when industries	v.
      1 wheeled	n.
      1 what things are made	prep.
      1 what they are made	prep.
      1 what remains	prep.
      1 what remains of something severely damaged	conj.
      1 what people speak	prep.
      1 what or which	n.
      1 what one	v.
      1 what one must do	prep.
      1 what one must do because it is right	conj.
      1 what one must do because it is	n.
      1 what kind	prep.
      1 what is right	conj.
      1 what is made with a	n.
      1 what is made	prep.
      1 what is important	prep.
      1 what	conj.
      1 what a person legally	conj.
      1 what a person legally and morally	v.
      1 what a person legally and morally should be able	prep.
      1 what a	n.
      1 we will present our idea	prep.
      1 we will	n.
      1 we will	ad.
      1 we talk	adj.
      1 we liked the	n.
      1 we have	ad.
      1 we can talk	adj.
      1 we can talk about it	prep.
      1 we can talk about it in the	ad.
      1 we ask the teacher questions every	n.
      1 we ask the teacher questions	ad.
      1 waves	prep.
      1 waves of	n.
      1 waves of energy from something that produces	v.
      1 waves of energy from something that produces heat	conj.
      1 waves of energy from something	pro.
      1 waves of energy from something	ad.
      1 water power turns	pro.
      1 water falling	prep.
      1 water falling from	pro.
      1 was	pro.
      1 was he	ad.
      1 wanting or	ad.
      1 wanting	conj.
      1 violent shaking	prep.
      1 violent shaking of the earth's	n.
      1 violent shaking of	pro.
      1 violent	n.
      1 very small	conj.
      1 very shortly	prep.
      1 very shortly before or after the	v.
      1 very shortly before or after the	n.
      1 very shortly before or after	pro.
      1 very shortly before	conj.
      1 very near	prep.
      1 very near in time or	v.
      1 very near in time	conj.
      1 very near in	n.
      1 very large or more than usual	prep.
      1 very large or more than usual in	n.
      1 very large	conj.
      1 vehicles or ships along a	n.
      1 vehicles or ships	ad.
      1 vehicles	conj.
      1 value measured	prep.
      1 value	conj.
      1 valley or road so people and vehicles	v.
      1 valley or road so people and vehicles can cross	prep.
      1 valley or road so people and vehicles can cross from one side to	pro.
      1 valley or road	ad.
      1 valley	conj.
      1 usually with	n.
      1 usually with many legs	conj.
      1 usually with	ad.
      1 usually used to	v.
      1 usually used to grow	n.
      1 usually used to grow crops	conj.
      1 usually used	prep.
      1 usually to	n.
      1 usually something bad	conj.
      1 usually something	ad.
      1 usually reached	conj.
      1 usually part	prep.
      1 usually part of	ad.
      1 usually made of paper	conj.
      1 usually made from	n.
      1 usually in winter or when	pro.
      1 usually in winter or	ad.
      1 usually in winter	conj.
      1 usually in the hands or	n.
      1 usually in the hands	conj.
      1 usually in	pro.
      1 usually in	n.
      1 usually in a religious or civil	n.
      1 usually in a religious	conj.
      1 usually in	ad.
      1 usually headed	conj.
      1 usually headed by a	n.
      1 usually headed by	ad.
      1 usually for a long	n.
      1 usually for	ad.
      1 usually filled with	n.
      1 usually filled	prep.
      1 usually feelings	prep.
      1 usually during a	n.
      1 usually by	n.
      1 usually an	n.
      1 usually an actor	conj.
      1 usually a long	n.
      1 usually a gas	conj.
      1 usually against an official army	conj.
      1 usually against an	n.
      1 usual daily	n.
      1 usual daily food	conj.
      1 usual daily food and	v.
      1 used to reject	conj.
      1 used to express agreement	conj.
      1 used to ask about what one or what ones of a	n.
      1 used to ask about what one	conj.
      1 used to ask about something or to ask for	n.
      1 used to ask about something	conj.
      1 used to ask about	pro.
      1 used to ask about	ad.
      1 used to affect the taste of	n.
      1 used to affect	pro.
      1 used most often	prep.
      1 used most often for windows or for containers to	v.
      1 used most often for windows	conj.
      1 used in front of a	v.
      1 used in front of a name word to show that it is a person or thing that is known	adj.
      1 used in front of a name word to show that it is a person	conj.
      1 used in front of a name word to show	pro.
      1 used in front of	ad.
      1 used in drinks	conj.
      1 used as proof or	v.
      1 used as proof or support	prep.
      1 used as an	v.
      1 used as an object	prep.
      1 used as an	n.
      1 used as	ad.
      1 use	conj.
      1 up to a	n.
      1 up	prep.
      1 until the	v.
      1 until the	ad.
      1 unless the	n.
      1 unless	pro.
      1 united states	n.
      1 unfair treatment or consideration based	prep.
      1 unfair treatment or consideration based on opinions	adj.
      1 unfair treatment or consideration based on opinions about a whole group instead of on	pro.
      1 unfair treatment or consideration based on opinions about	ad.
      1 unfair treatment	conj.
      1 unfair	n.
      1 understandings or ties	ad.
      1 understandings	conj.
      1 unborn	ad.
      1 two or more	n.
      1 two or	ad.
      1 two	conj.
      1 twelve o'clock	prep.
      1 twelve o'clock in	pro.
      1 true without	v.
      1 true without	n.
      1 true	prep.
      1 tribe	conj.
      1 transportation	conj.
      1 traditions	conj.
      1 traditions and arts	prep.
      1 traditions and arts of a	n.
      1 traditions and arts of	ad.
      1 to write something in order to have	pro.
      1 to write something in order to have it for	ad.
      1 to write something in	n.
      1 to write one's	n.
      1 to worry that something bad is near	conj.
      1 to worry	pro.
      1 to worry	ad.
      1 to work	conj.
      1 to work as	ad.
      1 to work	ad.
      1 to what	n.
      1 to watch	conj.
      1 to watch and protect a	n.
      1 to watch and protect	ad.
      1 to warn that one will do	n.
      1 to warn that one will do harm	conj.
      1 to warn	pro.
      1 to warn	ad.
      1 toward the	n.
      1 toward	pro.
      1 to want	ad.
      1 to walk together in a large	n.
      1 to walk together in a large group to protest	adj.
      1 to walk in a	n.
      1 to walk in	ad.
      1 to walk	ad.
      1 to wait for an	n.
      1 to wait for	ad.
      1 to use violence	conj.
      1 to use physical or mental	n.
      1 to use physical	conj.
      1 to use force to move something toward the person	conj.
      1 to use force to move something toward	pro.
      1 to use force to move something away from the person	conj.
      1 to use force to move something away from	pro.
      1 to use force to move something	ad.
      1 to use cigarettes or other tobacco products by burning them and breathing in the	n.
      1 to use cigarettes or other tobacco products by burning	pro.
      1 to use cigarettes or	ad.
      1 to use cigarettes	conj.
      1 to use an	n.
      1 to use a	n.
      1 to urge or	n.
      1 to urge or cause	ad.
      1 to urge	conj.
      1 to unite one thing or event with	ad.
      1 to unite one thing	conj.
      1 to unite one	n.
      1 to understand something	conj.
      1 to understand something as	ad.
      1 to understand	conj.
      1 touching the upper surface	prep.
      1 touching the upper	n.
      1 touching	pro.
      1 to turn the eyes toward	conj.
      1 to turn the eyes toward	ad.
      1 to turn	pro.
      1 to turn	conj.
      1 to turn	ad.
      1 to try with much	n.
      1 to try with	ad.
      1 to try to	n.
      1 to try to do	conj.
      1 to try to do as	n.
      1 to try to do as	ad.
      1 to travel in space around a planet	conj.
      1 to travel in space	ad.
      1 to travel in	n.
      1 to travel in a place that is not well known to learn more	adj.
      1 to travel in a place	pro.
      1 to travel in an	n.
      1 to travel in an airplane	conj.
      1 to travel in a	n.
      1 to touch with the mouth to show love	conj.
      1 to touch with the mouth to	n.
      1 to touch with	pro.
      1 to touch with	n.
      1 to tie	ad.
      1 to think or believe	pro.
      1 to think or believe	ad.
      1 to think	conj.
      1 to think about the	n.
      1 to think about the	ad.
      1 to think about	pro.
      1 to the other	n.
      1 to the	ad.
      1 to tell someone	pro.
      1 to tell someone	ad.
      1 to tell	pro.
      1 to tell of possible	n.
      1 to tell of	ad.
      1 to teach or learn	ad.
      1 to teach	conj.
      1 to talk about something	ad.
      1 to talk about a problem	conj.
      1 to talk about	ad.
      1 to take without permission	conj.
      1 to take to a higher	n.
      1 to take to	ad.
      1 to take something or someone from one place to	ad.
      1 to take something or someone from one	n.
      1 to take something	conj.
      1 to take quickly	conj.
      1 to take quickly by	n.
      1 to take part in	pro.
      1 to take part in a competition to decide who	conj.
      1 to take part in a competition to decide	pro.
      1 to take out of a position	conj.
      1 to take out of a	n.
      1 to take or move	ad.
      1 to take or bring up to a higher	n.
      1 to take or bring	ad.
      1 to take money	conj.
      1 to take liquid into	pro.
      1 to take into	pro.
      1 to take food into	pro.
      1 to take court action against a person to decide if	pro.
      1 to take court action against a person to decide	conj.
      1 to take court action	ad.
      1 to take away	conj.
      1 to take as a	n.
      1 to take and hold or to control by	n.
      1 to take air into the body	conj.
      1 to take air into the body and let it	ad.
      1 to take air into	pro.
      1 to suffer or die from a	n.
      1 to suffer or die from	ad.
      1 to suffer	conj.
      1 to study or examine all	n.
      1 to study or examine all information	adj.
      1 to study or examine	ad.
      1 to study	conj.
      1 to stretch out in	n.
      1 to stretch out in area	conj.
      1 to stretch	ad.
      1 to stop work	conj.
      1 to stop work as	ad.
      1 to stop	n.
      1 to stop from speaking or making	n.
      1 to stop from speaking	conj.
      1 to stop fighting	conj.
      1 to stop fighting and admit	n.
      1 to stop	conj.
      1 to stop and seize with	pro.
      1 to steal or get	n.
      1 to steal	conj.
      1 to stay the	ad.
      1 to stay	pro.
      1 to stay in a	n.
      1 to stay in	ad.
      1 to stay	ad.
      1 to start a	n.
      1 to start	ad.
      1 to spend	conj.
      1 to speak	conj.
      1 to sit on or in and be carried	ad.
      1 to sit on	conj.
      1 to signal	conj.
      1 to signal by moving the hand one way and the	ad.
      1 to signal by moving	pro.
      1 to show to be	ad.
      1 to show that one does not like	conj.
      1 to show or present	pro.
      1 to show or	ad.
      1 to show	conj.
      1 to shout approval	conj.
      1 to shoot a	n.
      1 to shoot	ad.
      1 to set or keep	n.
      1 to set in	n.
      1 to set	conj.
      1 to serve	conj.
      1 to serve as an	n.
      1 to serve as	ad.
      1 to send to another	n.
      1 to send to	ad.
      1 to send	n.
      1 to send into the	n.
      1 to send into the air	conj.
      1 to send into	pro.
      1 to send a	n.
      1 to send a message	conj.
      1 to seize or take control of a	n.
      1 to seize or take control of	ad.
      1 to seize or take by	n.
      1 to seize and take away by	n.
      1 to seize and take	ad.
      1 to seize a	n.
      1 to search for	pro.
      1 to search for animals to capture or kill	pro.
      1 to search for animals to capture	conj.
      1 to search	conj.
      1 to say words with	pro.
      1 to say what one believes will happen in the	n.
      1 to say what is wrong with something	conj.
      1 to say that one has a good feeling toward another because that	n.
      1 to say something	pro.
      1 to say something or to do something that makes another	n.
      1 to say something or to do something	pro.
      1 to say something or to do something	ad.
      1 to say something as a	n.
      1 to say something as	ad.
      1 to say something	adj.
      1 to say something	ad.
      1 to say or do	ad.
      1 to say good things	adj.
      1 to say	conj.
      1 to say a person is responsible for an act	conj.
      1 to say a person	conj.
      1 to run or go	ad.
      1 to run	conj.
      1 to run	ad.
      1 to rule	conj.
      1 to rule by	ad.
      1 to return to normal health	conj.
      1 to return to	n.
      1 to return to good	n.
      1 to rest the body	conj.
      1 to restrict to a number	conj.
      1 to restrict to a	n.
      1 to restrict to	ad.
      1 to rest	pro.
      1 to rest on	pro.
      1 to remove	conj.
      1 to remove by	n.
      1 to remain alive during or after a dangerous	n.
      1 to remain alive during	conj.
      1 to remain	ad.
      1 to release dangerous or unpleasant substances into the	n.
      1 to release dangerous or unpleasant substances into	pro.
      1 to release dangerous	conj.
      1 to reject	conj.
      1 to refuse to take part in	conj.
      1 to refuse to take	n.
      1 to refuse a	n.
      1 to refuse	ad.
      1 to reduce to small pieces	conj.
      1 to reduce to	ad.
      1 to reduce the	n.
      1 to reduce	pro.
      1 to record something so	pro.
      1 to record something	conj.
      1 to record something	ad.
      1 to recognize someone or something and to say who or	ad.
      1 to recognize someone or something and to say	pro.
      1 to recognize someone	conj.
      1 to recognize someone because you have met	conj.
      1 to recognize someone because you have met and talked	ad.
      1 to recognize someone because	pro.
      1 to receive sound through	pro.
      1 to receive or	n.
      1 to receive news	adj.
      1 to receive	conj.
      1 to reach a	n.
      1 to reach a goal	conj.
      1 to reach	ad.
      1 to put together into a	n.
      1 to put together	conj.
      1 to put the hand	conj.
      1 to put sound or pictures in a form	pro.
      1 to put sound or pictures in	ad.
      1 to put sound	conj.
      1 to put something over a	n.
      1 to put something over	ad.
      1 to put something	conj.
      1 to put	pro.
      1 to put or use in place of	ad.
      1 to put or use in	n.
      1 to put or pour something into a	n.
      1 to put or pour something into	ad.
      1 to put or keep in	n.
      1 to put objects on or into a	n.
      1 to put objects on or into	ad.
      1 to put objects on	conj.
      1 to put	n.
      1 to put in writing a number of names of people	conj.
      1 to put in writing a	n.
      1 to put in writing	ad.
      1 to put into the ground	conj.
      1 to put in place	conj.
      1 to put down or to keep down by	n.
      1 to put down	conj.
      1 to put different things together to make one	n.
      1 to put an official into office	conj.
      1 to put an official into office by having him or her promise to carry out	pro.
      1 to put a hand or hands around something and hold	pro.
      1 to put a hand	conj.
      1 to push down on the feet	conj.
      1 to push down on the feet and move up quickly into the	n.
      1 to push down on	pro.
      1 to push	ad.
      1 to punish or to get	n.
      1 to punish	conj.
      1 to pull on to make longer	conj.
      1 to provide	n.
      1 to protect	conj.
      1 to propose a person for an office	conj.
      1 to propose a	n.
      1 to propose	ad.
      1 to promise	pro.
      1 to produce a planned	n.
      1 to produce an	n.
      1 to prevent from increasing	conj.
      1 to prevent from being seen	conj.
      1 to prevent from being harmed	conj.
      1 to prevent	conj.
      1 to prevent any more	n.
      1 to prevent any more movement	conj.
      1 to prevent	ad.
      1 to present something	conj.
      1 to prepare for	ad.
      1 to praise a person	conj.
      1 to praise a god	conj.
      1 to point	ad.
      1 to plan and make something	ad.
      1 to place something so	pro.
      1 to place something	conj.
      1 to place something	ad.
      1 to permit to do	conj.
      1 to permit to be known or made	ad.
      1 to permit to be known	conj.
      1 to permit someone to use a	n.
      1 to permit someone to use	ad.
      1 to pay no	n.
      1 to pay no attention to	conj.
      1 to pay	conj.
      1 to pay	ad.
      1 to or toward that	v.
      1 to or toward that	n.
      1 to or toward	pro.
      1 to or toward	ad.
      1 to organize or develop an	n.
      1 to organize or develop	ad.
      1 to or from a great	n.
      1 to or from	ad.
      1 to or at this	v.
      1 to or at this	n.
      1 to or at	pro.
      1 to or at any	v.
      1 to or at any	n.
      1 to or at	ad.
      1 to oppose strongly	conj.
      1 tools or machines needed	prep.
      1 tools or machines needed for a	n.
      1 tools or machines needed for	ad.
      1 tools	conj.
      1 to offer reasons for or	ad.
      1 to offer reasons for	conj.
      1 to offer or propose something to think	adj.
      1 to offer	conj.
      1 to not reach a	n.
      1 to not	n.
      1 to need or demand as	ad.
      1 to need	n.
      1 to need help	conj.
      1 to need	conj.
      1 to name someone	conj.
      1 to name someone as	ad.
      1 to move with	n.
      1 to move to a higher	n.
      1 to move to	ad.
      1 to move through water	conj.
      1 to move through water by making motions with	pro.
      1 to move through the	n.
      1 to move through	pro.
      1 to move through	n.
      1 to move the	n.
      1 to move the body	conj.
      1 to move something over the surface of	ad.
      1 to move something over the	n.
      1 to move something over	pro.
      1 to move something	conj.
      1 to move smoothly over a	n.
      1 to move smoothly over	ad.
      1 to move smoothly	conj.
      1 to move quickly	conj.
      1 to move	pro.
      1 to move or cause to move one way and the	ad.
      1 to move or cause to move one way and	pro.
      1 to move or cause to move in	ad.
      1 to move or be moved gently on	n.
      1 to move	n.
      1 to move into or be in a position in	pro.
      1 to move into or be in a	n.
      1 to move into or be in	ad.
      1 to move into	conj.
      1 to move into a different	n.
      1 to move into	ad.
      1 to move goods or people from one place to	ad.
      1 to move goods	conj.
      1 to move from one place to	ad.
      1 to move from one	n.
      1 to move forces	conj.
      1 to move by putting one	n.
      1 to move by putting one foot in front of the	ad.
      1 to move by putting one foot in front of	pro.
      1 to move by lifting one	n.
      1 to move by lifting one foot and placing	pro.
      1 to move by lifting one foot and placing it in	ad.
      1 to mix or bring	ad.
      1 to mix	conj.
      1 to meet	conj.
      1 to measure how heavy someone	conj.
      1 to measure	ad.
      1 to make two sides or forces	ad.
      1 to make two sides	conj.
      1 to make sounds to express pleasure or	ad.
      1 to make sounds to express pleasure	conj.
      1 to make something go	conj.
      1 to make something exactly	ad.
      1 to make something	ad.
      1 to make someone do something or make something happen by using	n.
      1 to make someone do something	conj.
      1 to make someone believe something	pro.
      1 to make someone believe something	ad.
      1 to make sick with something that causes	n.
      1 to make sick with something	pro.
      1 to make public something	pro.
      1 to make or to become	ad.
      1 to make or become less in	n.
      1 to make or become	ad.
      1 to make one	ad.
      1 to make music sounds with	pro.
      1 to make music on	ad.
      1 to make more in size	conj.
      1 to make more in	n.
      1 to make less or smaller in	n.
      1 to make less in size	conj.
      1 to make less in	n.
      1 to make less	conj.
      1 to make known	conj.
      1 to make hot	conj.
      1 to make goods in	ad.
      1 to make good or	n.
      1 to make good	conj.
      1 to make better	conj.
      1 to make a sudden	n.
      1 to make a statement after being asked a	n.
      1 to make a solid into a	n.
      1 to make a solid into a liquid	conj.
      1 to make a solid into a liquid by heating	pro.
      1 to make a sign	conj.
      1 to make a request to a god	conj.
      1 to make a public show of opinions	conj.
      1 to make a public	n.
      1 to make a picture in	pro.
      1 to make a person	conj.
      1 to make an effort to gain knowledge	conj.
      1 to make an effort to gain knowledge by using	pro.
      1 to make a motion picture	conj.
      1 to make a hole in	pro.
      1 to make a great	n.
      1 to make a bomb harmless	conj.
      1 to lose	n.
      1 to look	conj.
      1 to look at	conj.
      1 to look at and understand	pro.
      1 to live through an	n.
      1 to live for a	n.
      1 to limit action	conj.
      1 to limit action by	ad.
      1 to lift	ad.
      1 to let something stay where	pro.
      1 to leave a job	conj.
      1 to learn the	n.
      1 to learn	pro.
      1 to know	pro.
      1 to know or sense through	pro.
      1 to know or remember something or someone	pro.
      1 to know or remember something or someone	ad.
      1 to know or	n.
      1 to know	ad.
      1 to kill	conj.
      1 to kill another	n.
      1 to kill	ad.
      1 to keep or put away for	n.
      1 to keep or put	ad.
      1 to keep in one	n.
      1 to keep for	n.
      1 to keep for	ad.
      1 to keep as	ad.
      1 to jump into water head	ad.
      1 to jump into	n.
      1 to join or hold together with some	n.
      1 to join or hold	ad.
      1 to join one thing to	ad.
      1 to join one	n.
      1 to join materials	ad.
      1 to join	conj.
      1 to join a	n.
      1 to join a man	conj.
      1 to increase two times	conj.
      1 to increase two times as much in	n.
      1 to increase two times as	ad.
      1 to increase in size	conj.
      1 to increase in	n.
      1 to include something in a	n.
      1 to include something in	ad.
      1 to improve	n.
      1 to imagine or believe that a	n.
      1 to imagine or believe	pro.
      1 to imagine or believe	ad.
      1 to imagine	conj.
      1 to honor a person	conj.
      1 to honor	ad.
      1 to hold up or in	n.
      1 to hold up	conj.
      1 to hold	n.
      1 to hit with the	n.
      1 to hit with	pro.
      1 to hit with	n.
      1 to hit with great	n.
      1 to hit with	ad.
      1 to hit or move with	n.
      1 to hit	conj.
      1 to hit again	conj.
      1 to hit	ad.
      1 to heat food before eating	pro.
      1 to heat a liquid until	pro.
      1 to heat a liquid	conj.
      1 to heat	ad.
      1 to have the same belief	conj.
      1 to have the facts	adj.
      1 to have or	n.
      1 to have or experience	ad.
      1 to have on the	n.
      1 to have on	pro.
      1 to have one's name officially placed on a list of people permitted to vote in an election	conj.
      1 to have one's name officially placed on	ad.
      1 to have one's body on the ground or	ad.
      1 to have one's body on the ground	conj.
      1 to have one's body on	pro.
      1 to have good feelings for someone	conj.
      1 to have before	pro.
      1 to have a picture or story in	pro.
      1 to have a picture	conj.
      1 to have an	n.
      1 to have an effect on someone	conj.
      1 to have a	n.
      1 to happen from a	n.
      1 to happen from	ad.
      1 to guard or fight	ad.
      1 to guard	conj.
      1 to govern	conj.
      1 to go up or down something by using	pro.
      1 to go up	conj.
      1 to go to or come to a	n.
      1 to go to or come to	ad.
      1 to go to	conj.
      1 to go or come	n.
      1 to go or come	ad.
      1 to go on doing	conj.
      1 to go from one side to	ad.
      1 to go from one place to	ad.
      1 to go from a position of sitting	conj.
      1 to go from a	n.
      1 to go from	ad.
      1 to go down into water	conj.
      1 to go down into	n.
      1 to go by or move	ad.
      1 to go and bring	n.
      1 to go and bring	ad.
      1 to give the results of a study	conj.
      1 to give the results of	ad.
      1 to give the	n.
      1 to give something needed	conj.
      1 to give something in exchange for	n.
      1 to give part of something to another	conj.
      1 to give part of something to	ad.
      1 to give or receive one thing for	ad.
      1 to give or receive one	n.
      1 to give or provide	pro.
      1 to give or provide	ad.
      1 to give or exchange	n.
      1 to give money to	ad.
      1 to give money to a business or organization with	pro.
      1 to give money to a business	conj.
      1 to give money for work done	conj.
      1 to give life	conj.
      1 to give control of oneself or one's property to	ad.
      1 to give control of oneself or one's	n.
      1 to give control of oneself	conj.
      1 to give bright	n.
      1 to get	n.
      1 to get knowledge	adj.
      1 to get in the	n.
      1 to get in	pro.
      1 together with its social	conj.
      1 together	prep.
      1 to get by	ad.
      1 to get again something	pro.
      1 to gather	n.
      1 to gain a	n.
      1 to gain	ad.
      1 to free from	n.
      1 to free from danger	conj.
      1 to form ideas in	pro.
      1 to forgive for a	n.
      1 to forgive for	ad.
      1 to forgive for a crime	conj.
      1 to force a person to leave his	conj.
      1 to force a gas	conj.
      1 to fool a person	conj.
      1 to fool	ad.
      1 to find	conj.
      1 to find an	n.
      1 to find	ad.
      1 to fight for	ad.
      1 to fight	conj.
      1 to fight	ad.
      1 to feel worry or	n.
      1 to feel worry	conj.
      1 to feel pain in the body	conj.
      1 to feel pain in	pro.
      1 to feel or show honor to	ad.
      1 to feel or	n.
      1 to feel	n.
      1 to feel	conj.
      1 to fall down	conj.
      1 to fall	conj.
      1 to fall	ad.
      1 to fail to obey or	n.
      1 to fail to obey	conj.
      1 to extend for a	n.
      1 to extend for	ad.
      1 to express wonder	conj.
      1 to express regret for a mistake or accident for	pro.
      1 to express regret for a mistake	conj.
      1 to express regret for	ad.
      1 to express or	n.
      1 to express one's thoughts to others	conj.
      1 to express one's guilt	conj.
      1 to express happiness or pleasure	ad.
      1 to express happiness	conj.
      1 to express an opinion	adj.
      1 to express an	n.
      1 to explain	conj.
      1 to examine what is different	conj.
      1 to examine	pro.
      1 to examine	ad.
      1 to establish	conj.
      1 to establish as a	n.
      1 to establish as	ad.
      1 to establish a	n.
      1 to establish	ad.
      1 to enter an	n.
      1 to enter an area	conj.
      1 to enter	ad.
      1 to end	pro.
      1 to employ for a	n.
      1 to employ for	ad.
      1 to drop to the	n.
      1 to drop to the ground or	ad.
      1 to drop to the ground	conj.
      1 to drop to	pro.
      1 to do work or	ad.
      1 to do work	conj.
      1 to do without something or to suffer	ad.
      1 to do without something	conj.
      1 to do the first	n.
      1 to do the	ad.
      1 to do something or to carry	ad.
      1 to do something	conj.
      1 to do	pro.
      1 to do or go	ad.
      1 to do	n.
      1 to do	conj.
      1 to divide or injure with a sharp	n.
      1 to divide or injure with	ad.
      1 to divide into parts	conj.
      1 to divide into parts by	n.
      1 to discover or learn something by searching or by	n.
      1 to discover	conj.
      1 to direct	conj.
      1 to direct and observe the	n.
      1 to direct and observe	pro.
      1 to dig useful or valuable substances out of the	n.
      1 to dig useful or valuable substances out of	pro.
      1 to dig useful or valuable substances	ad.
      1 to dig useful	conj.
      1 to die under	n.
      1 to develop	conj.
      1 to destroy or	n.
      1 to destroy	conj.
      1 to demand	conj.
      1 to delay action until a later	n.
      1 to delay action until	ad.
      1 to delay action	conj.
      1 to defeat	conj.
      1 to defeat another	conj.
      1 to defeat	ad.
      1 to declare the punishment for a	n.
      1 to declare the punishment for	ad.
      1 to declare	ad.
      1 to decide to do something at a later	n.
      1 to decide to do something at	ad.
      1 to decide between two	conj.
      1 to damage or destroy by	ad.
      1 to damage or destroy as	ad.
      1 to cut with	pro.
      1 to cut or push into or through with a pointed	n.
      1 to cut or push into or through with	ad.
      1 to cut into the	n.
      1 to cut into	pro.
      1 to cut	conj.
      1 to create a new thing	conj.
      1 to create a new	n.
      1 to create	ad.
      1 to cover with	ad.
      1 to control or to restrict freedoms by	n.
      1 to control by the use of unjust and cruel	n.
      1 to control by	pro.
      1 to control a moving	n.
      1 to control	ad.
      1 to continue thinking	pro.
      1 to continue thinking	ad.
      1 to continue for a longer	n.
      1 to continue for	ad.
      1 to consider	conj.
      1 to consider as an	n.
      1 to consider as	ad.
      1 to come to the	n.
      1 to come to	pro.
      1 to come to	n.
      1 to come to know a	n.
      1 to come to know a fact	conj.
      1 to come to know	adj.
      1 to come to know	ad.
      1 to come to know about	conj.
      1 to come together with someone or something at the same	n.
      1 to come together with someone or something at	pro.
      1 to come together with someone	conj.
      1 to come to a	n.
      1 to come to	ad.
      1 to come out of or to escape through a small opening or	n.
      1 to come out of	conj.
      1 to come or	n.
      1 to come or go	ad.
      1 to come or cause to come to	ad.
      1 to come or bring to an	n.
      1 to come or bring to	ad.
      1 to come between in order to settle	conj.
      1 to come between in	n.
      1 to choose	conj.
      1 to choose a	n.
      1 to choose	ad.
      1 to change to what is	n.
      1 to change to	pro.
      1 to change to	ad.
      1 to change from a	n.
      1 to change from	ad.
      1 to celebrate or	n.
      1 to celebrate	conj.
      1 to cause to stop for	ad.
      1 to cause to lose in	ad.
      1 to cause to lose in a battle	conj.
      1 to cause to go through the air	conj.
      1 to cause to go through the air by	ad.
      1 to cause to go through	pro.
      1 to cause to feel sudden surprise	conj.
      1 to cause to feel	ad.
      1 to cause to be	conj.
      1 to cause to be	ad.
      1 to cause someone to do something	conj.
      1 to cause physical damage to a person	conj.
      1 to cause or to become	ad.
      1 to cause or permit liquid to flow	ad.
      1 to cause injury	conj.
      1 to cause harm or damage to	ad.
      1 to cause harm	conj.
      1 to cause a gun	conj.
      1 to catch	conj.
      1 to carry	pro.
      1 to carry out a sexual	n.
      1 to carry out a sexual attack	conj.
      1 to carry	conj.
      1 to carry	ad.
      1 to call on somebody for	n.
      1 to buy with	n.
      1 to buy with money or with something of	ad.
      1 to buy with money	conj.
      1 to bring together a	n.
      1 to bring together a male	conj.
      1 to bring or gather together in one	n.
      1 to bring or gather	ad.
      1 to bring or come together into a	n.
      1 to bring or come	ad.
      1 to bring from another	n.
      1 to bring from	ad.
      1 to bring	ad.
      1 to break or be broken into small pieces by	n.
      1 to break or be broken into	ad.
      1 to break down	conj.
      1 to break	conj.
      1 to break apart violently with a loud	n.
      1 to break apart violently with	ad.
      1 to be unable to move	conj.
      1 to be pleased	conj.
      1 to be paid in return for	n.
      1 to be owned	conj.
      1 to be of the correct size	conj.
      1 to be of the correct	n.
      1 to be of the	ad.
      1 to be of	pro.
      1 to be necessary to have	conj.
      1 to be	n.
      1 to believe there is a good	n.
      1 to believe there is a good chance that something will happen	conj.
      1 to believe there is a good chance	pro.
      1 to believe that someone is honest	conj.
      1 to believe that someone is honest and will not	n.
      1 to believe	pro.
      1 to be in positions all around someone	conj.
      1 to be in positions	ad.
      1 to be in one position	conj.
      1 to be in one	n.
      1 to be employed by the	n.
      1 to be employed by	pro.
      1 to become	pro.
      1 to become part of or	ad.
      1 to become part of	conj.
      1 to become longer	conj.
      1 to become husband	conj.
      1 to become fixed in one position so	pro.
      1 to become fixed in one position	conj.
      1 to become fixed in one position	ad.
      1 to become fixed in one	n.
      1 to become a fact	conj.
      1 to be at a	n.
      1 to be at	ad.
      1 to be a	n.
      1 to attempt to	n.
      1 to attempt to learn or prove	pro.
      1 to attempt to learn or prove	ad.
      1 to attempt to learn	conj.
      1 to attempt to defeat or destroy	ad.
      1 to attempt to defeat	conj.
      1 to attack	conj.
      1 to attach something to another thing using a substance	pro.
      1 to attach something to another	n.
      1 to attach something to	ad.
      1 to assist or	n.
      1 to assist	conj.
      1 to ask with	n.
      1 to ask someone to take part in or join	ad.
      1 to ask someone to take part in	conj.
      1 to ask someone to take	n.
      1 to ask for or	n.
      1 to ask for	conj.
      1 to ask	conj.
      1 to argue for or	ad.
      1 to argue for	conj.
      1 to another	n.
      1 to aim or show	pro.
      1 to aim	conj.
      1 to aim	ad.
      1 to agree with others	conj.
      1 to agree with others and	n.
      1 to agree with others and help them reach	ad.
      1 to agree with others and help	pro.
      1 to agree	adj.
      1 to advise or inform	adj.
      1 to advise or inform about something bad	pro.
      1 to advise or inform about something	ad.
      1 to advise	conj.
      1 to add to	conj.
      1 to act with many others in a violent	n.
      1 to act with	ad.
      1 to act toward in a special	n.
      1 to act toward in	ad.
      1 to act or work	ad.
      1 to act or	n.
      1 to act in the	n.
      1 to act in	pro.
      1 to act as a	n.
      1 to act as	ad.
      1 to act against a	n.
      1 to act against a government	conj.
      1 to act	ad.
      1 to accuse of being wrong	conj.
      1 to accuse of being	ad.
      1 to accept the rule	conj.
      1 to accept the	n.
      1 to accept	pro.
      1 to accept	conj.
      1 to accept as	ad.
      1 to accept another nation	conj.
      1 to accept another	n.
      1 to accept	ad.
      1 tissue	prep.
      1 tissue in the bodies of humans	conj.
      1 tissue in the bodies of humans and animals used to	v.
      1 tissue in the bodies of humans and animals used to store energy and to keep	ad.
      1 tissue in	pro.
      1 time or effort with	ad.
      1 time or effort	prep.
      1 time	conj.
      1 time	ad.
      1 through the whole	n.
      1 through the	ad.
      1 through space	conj.
      1 through	pro.
      1 through	n.
      1 three or	ad.
      1 three	conj.
      1 those plants that	v.
      1 those plants	pro.
      1 those plants	ad.
      1 those ones being spoken	adj.
      1 this pulling	v.
      1 this pulling	n.
      1 thin	v.
      1 thin piece	prep.
      1 thin piece of metal used to	v.
      1 thin piece of metal used to hang objects	conj.
      1 thin mark	prep.
      1 thin mark on a	n.
      1 think	conj.
      1 things owned or made to	v.
      1 things owned or made	prep.
      1 things owned	conj.
      1 things or ideas away	prep.
      1 things or ideas	ad.
      1 things	conj.
      1 thin container	prep.
      1 thin container in which they	v.
      1 thin container in	pro.
      1 thick piece	prep.
      1 thick	n.
      1 they will observe the	n.
      1 they will observe the anniversary	prep.
      1 they will hold talks	n.
      1 they were responsible	prep.
      1 they were responsible for the	n.
      1 they were members	prep.
      1 they were members of the	n.
      1 they were members of the	ad.
      1 they travelled	prep.
      1 they travelled for one	n.
      1 they stayed	prep.
      1 they stayed in	ad.
      1 they saw us	n.
      1 they plan to have	ad.
      1 they plan	prep.
      1 they	n.
      1 they formed a	v.
      1 they formed a swim	n.
      1 they formed	ad.
      1 they called	prep.
      1 they called for an	v.
      1 they called for an	n.
      1 they called for	ad.
      1 they believe	prep.
      1 they believe in	n.
      1 they are willing to	v.
      1 they are willing to talk	adj.
      1 they are willing to	n.
      1 they are willing	prep.
      1 they are	v.
      1 they are the ones who want	prep.
      1 they are the ones who	v.
      1 they are seeking a	n.
      1 they are seeking	ad.
      1 they are seeking a cure	prep.
      1 they are	ad.
      1 the written	v.
      1 the written record or description	prep.
      1 the written record or description of	ad.
      1 the written record	conj.
      1 the written general laws	conj.
      1 the written general laws and ideas that	v.
      1 the written general laws and ideas that form a nation's system	prep.
      1 the written	ad.
      1 the work that one does	prep.
      1 the work necessary	prep.
      1 the work	conj.
      1 the work and related activity	prep.
      1 the white	n.
      1 the white liquid produced	conj.
      1 the white liquid produced by female animals to	v.
      1 the white liquid produced by female animals	prep.
      1 the weather scientist predicted	ad.
      1 the way things are during a period	prep.
      1 the way things are	ad.
      1 the way in which a person	conj.
      1 the way in which	ad.
      1 the way a thing is	v.
      1 the way a thing is set	conj.
      1 the way	ad.
      1 the warmest time	prep.
      1 the warmest	n.
      1 the wall is two meters	ad.
      1 the violation	prep.
      1 the violation of	ad.
      1 the usual	n.
      1 the use of scientific	n.
      1 the use of scientific knowledge	conj.
      1 the use of medicine to try to cure or make	ad.
      1 the use of medicine to try to cure	conj.
      1 the upper	n.
      1 the upper edge	conj.
      1 the two sides	v.
      1 the two sides hold talks this	n.
      1 the two nations	v.
      1 the two nations have strong	n.
      1 the two nations have	ad.
      1 the two men were	n.
      1 the top part	prep.
      1 the time of the year between winter	conj.
      1 the time of the year between summer	conj.
      1 the time gone	conj.
      1 the time between	conj.
      1 the time between being	v.
      1 the time between being born	conj.
      1 the thing or person that produces a	v.
      1 the thing or person	ad.
      1 the thing	conj.
      1 the test	prep.
      1 the test of the	ad.
      1 the territory	prep.
      1 the territory of	ad.
      1 the telling or writing	prep.
      1 the telling or writing of an	n.
      1 the telling or writing of	ad.
      1 the telling	conj.
      1 the teacher demonstrated the	n.
      1 the teacher demonstrated the idea with an	v.
      1 the teacher demonstrated the idea with	ad.
      1 the teacher demonstrated the idea	prep.
      1 the talks will	n.
      1 the talks will deal	prep.
      1 the talks will	ad.
      1 the talks should begin	ad.
      1 the system of sending pictures	conj.
      1 the system of sending pictures and sounds by electronic signals over a distance so others	v.
      1 the system of sending pictures and sounds by electronic signals over	ad.
      1 the system of sending	conj.
      1 the system of government in which citizens vote to choose leaders or to make	ad.
      1 the system of government in which citizens vote to choose leaders	conj.
      1 the system of government in which citizens	v.
      1 the system	conj.
      1 the study of the	n.
      1 the study of the	ad.
      1 the study of nature	conj.
      1 the study of nature and the actions of	ad.
      1 the students did well	prep.
      1 the students did well on the language	v.
      1 the students did	n.
      1 the students did	ad.
      1 the student paid	n.
      1 the student paid attention	prep.
      1 the story	adj.
      1 the story about	ad.
      1 the storm had a serious effect	prep.
      1 the storm had	ad.
      1 the stock	prep.
      1 the stock of	ad.
      1 the spirit that is honored	conj.
      1 the spirit that is honored as creator	prep.
      1 the spirit	ad.
      1 the space occupied	conj.
      1 the space	ad.
      1 the sound made	conj.
      1 the solid	n.
      1 the solid material	prep.
      1 the smell	prep.
      1 the smallest part	prep.
      1 the smallest part of an element that	v.
      1 the smallest part of	ad.
      1 the smallest amount	prep.
      1 the smallest amount of	ad.
      1 the smallest amount of a chemical substance that	v.
      1 the smaller	prep.
      1 the smaller of the two groups in the governments of	ad.
      1 the smaller	n.
      1 the sky is	ad.
      1 the side	prep.
      1 the side of a room	conj.
      1 the side of	ad.
      1 the sharp	v.
      1 the sharp	n.
      1 the sharp end	prep.
      1 the sex that is the father	prep.
      1 the settlement	prep.
      1 the settlement of an argument where each side agrees to	v.
      1 the settlement of an argument where each side agrees to accept less	conj.
      1 the settlement of an argument where each	n.
      1 the settlement of	ad.
      1 these shoes	v.
      1 the seed	prep.
      1 the scientists will test the	ad.
      1 the scientists will	n.
      1 the scientists	v.
      1 the scientific study of the	n.
      1 the scientific study of the environment	conj.
      1 the scientific study of the environment and links	ad.
      1 the scientific study of stars	conj.
      1 the scientific study of stars and the	n.
      1 the scientific study of past human life	conj.
      1 the scientific study of life or living things in	ad.
      1 the scientific study of life	conj.
      1 the scientific study of	ad.
      1 the science	prep.
      1 the science or	v.
      1 the science or study	prep.
      1 the science of changing the genes of	ad.
      1 the science dealing	prep.
      1 the science	conj.
      1 the school is five kilometers	prep.
      1 the same	prep.
      1 the same in	n.
      1 the rounded	v.
      1 the rounded object containing unborn young produced	conj.
      1 the rounded object containing unborn	ad.
      1 the rounded	n.
      1 the room was	ad.
      1 the rocket landed	prep.
      1 the river flows	prep.
      1 there was only one case	prep.
      1 there was only one case of chicken pox at the	n.
      1 there was only one case of chicken pox at	pro.
      1 there was a	v.
      1 there was a	n.
      1 there was a list	prep.
      1 the results	prep.
      1 the results of a	v.
      1 the results of a study	conj.
      1 the results of	ad.
      1 the result	conj.
      1 the report	prep.
      1 the report on the meeting is	ad.
      1 the remains	prep.
      1 the remains of a person	conj.
      1 the remains of	ad.
      1 the remaining one or ones	prep.
      1 the remaining one or ones of two or	ad.
      1 the remaining one	conj.
      1 the reason	prep.
      1 the reason or desired effect	prep.
      1 the reason	conj.
      1 there are two kinds	prep.
      1 there are two kinds of	n.
      1 the rate at which something moves	conj.
      1 the rate at which something happens	conj.
      1 the quality of being	ad.
      1 the punishment	prep.
      1 the punishment for a	n.
      1 the punishment for	ad.
      1 the price	prep.
      1 the price or value	prep.
      1 the price of any thing	conj.
      1 the price of	ad.
      1 the price	conj.
      1 the position	prep.
      1 the position of something	conj.
      1 the police persuaded the criminal to	v.
      1 the police persuaded the criminal	prep.
      1 the police detained several suspects	prep.
      1 the police detained	ad.
      1 the plan will	ad.
      1 the plant	ad.
      1 the planet we all	v.
      1 the planet we all live	prep.
      1 the planet we	ad.
      1 the place where one was born or comes	prep.
      1 the place where one was born	conj.
      1 the place	prep.
      1 the place in the	ad.
      1 the physical	n.
      1 the physical equipment	prep.
      1 the physical equipment of a computer	conj.
      1 the physical activity	conj.
      1 the physical activity by which humans and animals	v.
      1 the physical activity by which humans and animals	n.
      1 the person or persons being spoken	prep.
      1 the people who	v.
      1 the people who live	prep.
      1 the people who	ad.
      1 the path or way an	v.
      1 the path or way an object travels	prep.
      1 the path or way	ad.
      1 the path is	v.
      1 the path is	ad.
      1 the path	conj.
      1 the part which comes	v.
      1 the part which comes	ad.
      1 the part of the earth not covered	conj.
      1 the part of the earth	ad.
      1 the part of the body that touches the ground	conj.
      1 the part of the body	ad.
      1 the part of a plant that is under the ground	conj.
      1 the part of a person that is believed to	v.
      1 the part of a human that is not physical	conj.
      1 the part of a country's military	v.
      1 the outer surfaces	prep.
      1 the outer surfaces of an	v.
      1 the outer surfaces of an object that are not the top	conj.
      1 the outer surfaces of an	n.
      1 the outer surfaces of	ad.
      1 the outer side or top	prep.
      1 the outer side	conj.
      1 the outer	n.
      1 the outer covering	prep.
      1 the outer covering of humans	conj.
      1 the outer covering of humans and	ad.
      1 the other way	prep.
      1 the other	n.
      1 the organization of people elected to	v.
      1 the organization of people	ad.
      1 the opposite	prep.
      1 the opposite of	n.
      1 the one	ad.
      1 the official permission given to a person to	v.
      1 the official permission given to a person to enter a country where he	conj.
      1 the official permission given	prep.
      1 the official dinner took	v.
      1 the official dinner took place	prep.
      1 the official center	prep.
      1 the offices	prep.
      1 the offices of an	n.
      1 the offices of an ambassador	conj.
      1 the offices of	ad.
      1 the number meaning none	conj.
      1 the nucleus	prep.
      1 the nucleus of an atom is	v.
      1 the nucleus of	ad.
      1 the normal weather conditions	prep.
      1 the normal weather conditions of a	v.
      1 the need	prep.
      1 the need for	n.
      1 the natural world	prep.
      1 the natural world of	v.
      1 the natural	n.
      1 the movement of water	ad.
      1 the mother	conj.
      1 the most important	conj.
      1 the money a person or business	v.
      1 the money a person or business must pay	prep.
      1 the money a person	conj.
      1 the money	ad.
      1 the mixture	prep.
      1 the mixture of gases around the	n.
      1 the mixture of gases	ad.
      1 the measurement	prep.
      1 the measurement of	v.
      1 the measurement of	n.
      1 the measurement of heat	conj.
      1 the measurement of heat and	ad.
      1 the material	prep.
      1 the man was standing	ad.
      1 the making	prep.
      1 the making of sounds	conj.
      1 the making of sounds by singing or using a musical	n.
      1 the making of sounds by singing or using	ad.
      1 the main offices	prep.
      1 the main offices of a	n.
      1 the main offices of a business	conj.
      1 the main	n.
      1 the main amount	prep.
      1 the lowest part	prep.
      1 the lowest	n.
      1 the liquid that falls	prep.
      1 the liquid that falls from the sky	conj.
      1 the liquid	conj.
      1 the liquid and solid substances that	v.
      1 the liquid and solid substances that result	prep.
      1 the liquid and	ad.
      1 the liquid	ad.
      1 the line where something ends	conj.
      1 the level	prep.
      1 the level of	ad.
      1 the leader	prep.
      1 the leader of	ad.
      1 the law is	ad.
      1 the jury finds the man guilty	prep.
      1 the jury finds the man guilty of	v.
      1 the jury finds the man	ad.
      1 the job was	ad.
      1 the job one does to	v.
      1 the job one does	prep.
      1 their	n.
      1 their goods are	prep.
      1 their goods are of	pro.
      1 the huge star	prep.
      1 the huge star in the sky that provides	v.
      1 the huge star in the sky that provides heat	conj.
      1 the huge	n.
      1 the house of representatives	conj.
      1 the hours	prep.
      1 the heat	conj.
      1 the heat and	ad.
      1 the head or leader	prep.
      1 the head or leader of	ad.
      1 the head	conj.
      1 the hard	n.
      1 the hard material	prep.
      1 the group that includes children	conj.
      1 the group	ad.
      1 the ground	conj.
      1 the greatest	n.
      1 the greatest amount	conj.
      1 the greater	n.
      1 the government collapsed after a vote	prep.
      1 the government collapsed after a	v.
      1 the government collapsed	ad.
      1 the girl or woman who is being spoken	adj.
      1 the girl	conj.
      1 the general condition	prep.
      1 the general condition of the body	conj.
      1 the gas that comes	prep.
      1 the gases surrounding any star	conj.
      1 the gases surrounding any	n.
      1 the gases surrounding	ad.
      1 the gas	ad.
      1 the fruit tastes	ad.
      1 the front	prep.
      1 the forward	n.
      1 the form of something with different details	conj.
      1 the form of something with	ad.
      1 the forest is	ad.
      1 the force that pulls things	prep.
      1 the force produced	conj.
      1 the force produced	ad.
      1 the force	ad.
      1 the first	n.
      1 the fire was	prep.
      1 the fire was on the	ad.
      1 the fine material that grows	prep.
      1 the feeling caused	conj.
      1 the feeling caused by something	ad.
      1 the family had its dinner	prep.
      1 the extensive communications system	ad.
      1 the extensive communications	n.
      1 the experience caused her	ad.
      1 the executive part	prep.
      1 the executive part of	ad.
      1 the executive	n.
      1 the end	prep.
      1 the end of a trip	conj.
      1 the end of	ad.
      1 the effort used to	v.
      1 the effort used to make	conj.
      1 the effort used	prep.
      1 the edge	prep.
      1 the edge of an area protected	conj.
      1 the edge of	ad.
      1 the earth's	n.
      1 the early part	prep.
      1 the early	n.
      1 the doctor	v.
      1 the distance	prep.
      1 the direction in which the sun goes	ad.
      1 the different events or parts	prep.
      1 the different events or parts of a meeting or	v.
      1 the different events or parts of a meeting or	n.
      1 the different events	conj.
      1 the different effects	prep.
      1 the different effects of	n.
      1 the day	prep.
      1 the day	ad.
      1 the crowd demonstrated	prep.
      1 the crowd demonstrated in	v.
      1 the crowd demonstrated in support of	ad.
      1 the crop	ad.
      1 the crime	prep.
      1 the crime of killing	ad.
      1 the cover	prep.
      1 the cost	prep.
      1 the correct or	n.
      1 the correct	conj.
      1 the control	n.
      1 the control center	prep.
      1 the conditions	prep.
      1 the conditions of an agreement that	v.
      1 the conditions of an agreement that have been accepted	conj.
      1 the conditions of	ad.
      1 the condition of being in	ad.
      1 the condition of being free from sickness	conj.
      1 the colored part	prep.
      1 the colored part of plants that	v.
      1 the colored part of plants	ad.
      1 the colored	n.
      1 the coldest time	prep.
      1 the coldest	n.
      1 the city where	ad.
      1 the child's	n.
      1 the child's behavior was bad	prep.
      1 the child's behavior was	ad.
      1 the chief official of a city	conj.
      1 the chief justice will swear	prep.
      1 the chief justice	v.
      1 the chance	prep.
      1 the center	prep.
      1 the center part	prep.
      1 the center part of an atom	conj.
      1 the center part of	ad.
      1 the cause	prep.
      1 the cause for	ad.
      1 the cause for a belief	conj.
      1 the bullets or shells fired	prep.
      1 the bullets	conj.
      1 the building where	ad.
      1 the building collapsed	prep.
      1 the building	ad.
      1 the bright	v.
      1 the bright object often seen	prep.
      1 the bright object often seen in the night sky that orbits the earth	adj.
      1 the bright	n.
      1 the brain	prep.
      1 the brain of	ad.
      1 the brain of a computer which carries out software instructions that	v.
      1 the brain of a computer which carries out software instructions that operate the hardware of the computer	conj.
      1 the boy or man who is being spoken	adj.
      1 the boy	conj.
      1 the book is	prep.
      1 the book fell	prep.
      1 the baseball	n.
      1 the baseball fan attended	ad.
      1 the armed forces	prep.
      1 the armed forces of a nation	conj.
      1 the armed forces of a	n.
      1 the armed forces of	ad.
      1 the area	prep.
      1 the area of salt water	ad.
      1 the area	conj.
      1 the area between	conj.
      1 the area	ad.
      1 the amount or height that something reaches or rises	prep.
      1 the amount or height	ad.
      1 the amount of space between two places	conj.
      1 the amount of space	ad.
      1 the amount of something that	v.
      1 the amount of something that can be given	conj.
      1 the amount of something	ad.
      1 the amount of money that could	v.
      1 the amount of money that could be received	conj.
      1 the amount of money	ad.
      1 the amount	conj.
      1 the american	n.
      1 the actor's	n.
      1 the actor's career lasted	prep.
      1 the act or	n.
      1 the act or business	prep.
      1 the act of touching or being close to a	n.
      1 the act of touching or being	ad.
      1 the act of touching	conj.
      1 the act of presenting	conj.
      1 the act of moving or a	n.
      1 the act of moving or	ad.
      1 the act of moving	conj.
      1 the act of fighting against one's own	n.
      1 the act of fighting against one's own country	conj.
      1 the act of fighting	ad.
      1 the act of causing severe	n.
      1 the act of causing	ad.
      1 the activity	prep.
      1 the activities	prep.
      1 the activities of	n.
      1 the activities of government	conj.
      1 the activities of government and of those who are in	ad.
      1 the act	conj.
      1 the ability to think	conj.
      1 the ability to control or	ad.
      1 the ability to control	conj.
      1 the ability gained	prep.
      1 the ability gained from training or	v.
      1 the ability gained from training or	n.
      1 the ability gained from training	conj.
      1 the ability	conj.
      1 the ability and willingness to	v.
      1 the ability and willingness	prep.
      1 that which	v.
      1 that which something is known to	v.
      1 that which something is known to have	conj.
      1 that which something is known	prep.
      1 that which needs	n.
      1 that which is taken	prep.
      1 that which is taken in	conj.
      1 that which is taken in by all living things for	n.
      1 that which is produced	conj.
      1 that which is produced by burning	n.
      1 that which is presented	conj.
      1 that which is measured	prep.
      1 that which is aimed	prep.
      1 that which follows or is produced by a	v.
      1 that which follows or is produced by a	n.
      1 that which follows	conj.
      1 that which causes	v.
      1 that which causes	n.
      1 that which causes great	v.
      1 that which causes great	n.
      1 that which can be seen rising into the air like a cloud	prep.
      1 that we	v.
      1 that toward which an	n.
      1 that something is believed to	v.
      1 that something is believed to be a good	n.
      1 that something is believed	prep.
      1 that	prep.
      1 that country has a	v.
      1 ten is ten percent	prep.
      1 ten is ten	n.
      1 television	conj.
      1 taxes	prep.
      1 talks	ad.
      1 talking or	ad.
      1 talking	conj.
      1 taking the	v.
      1 taking the place	prep.
      1 taking the	n.
      1 taking	pro.
      1 take or send	n.
      1 take or send	ad.
      1 taken or directed to or away from a	v.
      1 taken or directed to or away from a	n.
      1 taken or directed to or	ad.
      1 taken or directed	prep.
      1 taken	conj.
      1 take	conj.
      1 swimming is a	v.
      1 swimming is a	n.
      1 swimming is a form	prep.
      1 swimming is	ad.
      1 surrounded	conj.
      1 supported	conj.
      1 suffering physically or mentally with a	n.
      1 suffering physically or mentally with	ad.
      1 suffering physically or mentally	prep.
      1 suffering physically	conj.
      1 suffering or loss	prep.
      1 suffering or loss for doing something	ad.
      1 suffering	conj.
      1 such as the heart or	n.
      1 such as putting	n.
      1 such as putting medicine or drugs into the body	prep.
      1 such as putting medicine or drugs into	pro.
      1 such as	pro.
      1 such as	prep.
      1 such as in	pro.
      1 such as a post	n.
      1 such as an	n.
      1 such as an earthquake or plane	v.
      1 such as a liquid that does not	v.
      1 such as a liquid	pro.
      1 such action is not permitted under the	n.
      1 such action is not permitted under	pro.
      1 such action is not permitted	prep.
      1 substances used	prep.
      1 substances used in the	n.
      1 substances used in	pro.
      1 substances responsible	prep.
      1 substances responsible for the growth of tissue	conj.
      1 substances responsible for the growth of	n.
      1 substances responsible for	pro.
      1 substances or	n.
      1 substances or matter	prep.
      1 substances or matter of which something is made or from which something	v.
      1 substances or matter of	pro.
      1 substances	conj.
      1 substances	ad.
      1 studied or written	adj.
      1 studied	conj.
      1 strong	conj.
      1 strong and clear	prep.
      1 strong and clear in	n.
      1 strength used against a person or	v.
      1 strength used against a person	conj.
      1 strength used against a	n.
      1 strength used	ad.
      1 strength or	n.
      1 straight	prep.
      1 stories or	n.
      1 stories and writings	prep.
      1 stories and writings of a	n.
      1 stories and writings of	ad.
      1 store or place	prep.
      1 store	conj.
      1 stone or	ad.
      1 stone	conj.
      1 stolen or taken	ad.
      1 stolen	conj.
      1 steel	conj.
      1 special proteins produced	prep.
      1 special proteins produced in the blood that	v.
      1 special proteins produced in	pro.
      1 special	n.
      1 space where a person	conj.
      1 space where	ad.
      1 so they could not	v.
      1 so	pro.
      1 some	v.
      1 sometimes used	conj.
      1 sometimes used as a	n.
      1 sometimes used as	ad.
      1 sometimes	prep.
      1 sometimes involving	n.
      1 sometimes in a	n.
      1 sometimes in	ad.
      1 sometimes	ad.
      1 something to	v.
      1 something thrown away	conj.
      1 something thrown away as having no	n.
      1 something thrown	ad.
      1 something that shows what another thing looks	v.
      1 something that shows what another	n.
      1 something that one has done or lived	prep.
      1 something that one has done	conj.
      1 something that makes a sick	n.
      1 something that is published such	conj.
      1 something that is published such as a	n.
      1 something that is not or cannot	v.
      1 something that is not	conj.
      1 something that greatly affects the	n.
      1 something that greatly affects the mind	conj.
      1 something sent to another	n.
      1 something sent to	ad.
      1 something sent	prep.
      1 something sensed	conj.
      1 something sensed by	pro.
      1 something organized to	v.
      1 something organized to be seen	conj.
      1 something organized to be seen by the	ad.
      1 something organized to be seen by	pro.
      1 something organized	prep.
      1 something of value that one	v.
      1 something of value	pro.
      1 something of value	ad.
      1 something of	n.
      1 something offered or won	prep.
      1 something offered or won in	ad.
      1 something offered	conj.
      1 something not alive that	v.
      1 something not alive that	n.
      1 something not alive that can be seen	conj.
      1 something not alive	pro.
      1 something made to	v.
      1 something made to look exactly	ad.
      1 something made	prep.
      1 something less than	pro.
      1 something less	conj.
      1 something known or proved to	v.
      1 something known or proved to be	ad.
      1 something known or proved	prep.
      1 something known only to a few	conj.
      1 something known only to a few and kept from	n.
      1 something known only	prep.
      1 something known	conj.
      1 something known	ad.
      1 something is making the	n.
      1 something is making the door	v.
      1 something is making	pro.
      1 something given without	v.
      1 something given without	n.
      1 something given	prep.
      1 something done or said to	v.
      1 something done or said to	n.
      1 something done or said	prep.
      1 something done or made to	v.
      1 something done or made to	n.
      1 something done or made to honor the memory of	ad.
      1 something done or made to honor	pro.
      1 something done or made	prep.
      1 something declared necessary	prep.
      1 something declared	ad.
      1 something built to	v.
      1 something built to travel on water that carries people	conj.
      1 something built to travel on water	pro.
      1 something built to travel on water	ad.
      1 something built to travel on	n.
      1 something built	prep.
      1 something brought	prep.
      1 something brought from another	n.
      1 something brought from	ad.
      1 something around an	n.
      1 something around an area	prep.
      1 something around an area of	v.
      1 something around an area of land to keep animals	conj.
      1 someone who was	v.
      1 someone who was born	prep.
      1 someone who was born in a	n.
      1 someone who was born in	ad.
      1 someone or something	pro.
      1 someone or something	ad.
      1 someone active	prep.
      1 someone active in trying to	v.
      1 someone active in trying to	n.
      1 someone acting	prep.
      1 someone acting in a	v.
      1 someone acting in a play	conj.
      1 someone acting in a	n.
      1 someone acting in	ad.
      1 some	n.
      1 sold or offered	prep.
      1 sold	conj.
      1 soil	conj.
      1 smell	conj.
      1 small towns	conj.
      1 small	prep.
      1 small in	n.
      1 smaller	prep.
      1 smaller in	n.
      1 sizes	conj.
      1 size or weight	prep.
      1 size or distance	prep.
      1 size or amount using	ad.
      1 situations	conj.
      1 situation or	v.
      1 showing the person or	v.
      1 showing the person or place toward which	ad.
      1 showing the person or place	prep.
      1 showing the person	conj.
      1 showing the direction	prep.
      1 showing the direction of	ad.
      1 showing strong friendship	conj.
      1 showing strong friendship and	v.
      1 showing strong friendship and support	prep.
      1 showing a	n.
      1 showing a goal	conj.
      1 short term	prep.
      1 short	n.
      1 she works	prep.
      1 she works for a	n.
      1 she works for	ad.
      1 she wonders if it is	ad.
      1 she wonders	conj.
      1 she seems to	v.
      1 she seems to be in good	n.
      1 she seems to be in	ad.
      1 she seems	prep.
      1 she is	v.
      1 she is the	v.
      1 she is the last person	prep.
      1 she is the last	n.
      1 she is the	ad.
      1 she is seeking election to public	n.
      1 she is seeking election to	ad.
      1 she is seeking election	prep.
      1 she is firm	prep.
      1 she is firm in her	n.
      1 she is expected to	v.
      1 she is expected	prep.
      1 she had a great	n.
      1 she had a great interest	prep.
      1 she had	ad.
      1 she found the	v.
      1 she found the report	prep.
      1 she found the report in	ad.
      1 she found the	n.
      1 she experienced great	n.
      1 she experienced	ad.
      1 she donated	n.
      1 she donated money to the red	v.
      1 she donated money to the	ad.
      1 she donated money	prep.
      1 she	ad.
      1 shared	conj.
      1 shared by two or	ad.
      1 separated	prep.
      1 sending	ad.
      1 selling	conj.
      1 seen	conj.
      1 security was increased	prep.
      1 security was increased in	pro.
      1 security	v.
      1 security can also mean a financial contract	pro.
      1 security can	ad.
      1 schools	conj.
      1 schools and roads are services paid	prep.
      1 same	prep.
      1 sadness or	v.
      1 sadness or	n.
      1 sadness	conj.
      1 ruling	v.
      1 ruling	n.
      1 round structure through which liquids or gases	v.
      1 round structure through which liquids	conj.
      1 round structure through	pro.
      1 round structure	prep.
      1 round piece	prep.
      1 round piece of material used to	v.
      1 round piece of material used to move liquid	conj.
      1 rockets producing bright	v.
      1 rockets producing bright	n.
      1 rockets producing bright fire	prep.
      1 rockets producing bright fire in	pro.
      1 rockets producing	ad.
      1 road	conj.
      1 rivers	conj.
      1 riding or	n.
      1 riding or farm	v.
      1 riding	conj.
      1 rich	prep.
      1 rich in production of plants	conj.
      1 rice	conj.
      1 restrictions	conj.
      1 responsible	prep.
      1 representing the	n.
      1 representing the	ad.
      1 representing	pro.
      1 representative	prep.
      1 religion	conj.
      1 red	n.
      1 red fluid	prep.
      1 red fluid in	pro.
      1 ready to	n.
      1 ready to listen to reasons	conj.
      1 ready or willing to	n.
      1 ready or willing	prep.
      1 ready for	n.
      1 ready	conj.
      1 reach	conj.
      1 rainy	n.
      1 racial or ethnic	n.
      1 racial or	ad.
      1 racial	conj.
      1 quick to	v.
      1 quick to understand	conj.
      1 quick	prep.
      1 provide or	n.
      1 provided	pro.
      1 provided	ad.
      1 provide	conj.
      1 producing	ad.
      1 processes	conj.
      1 processes and materials	prep.
      1 processes and materials in	n.
      1 prime	n.
      1 price or	v.
      1 price	conj.
      1 present	conj.
      1 present and ready	prep.
      1 power used to	v.
      1 power used	prep.
      1 powerful	n.
      1 powerful	ad.
      1 possibly	ad.
      1 position or	v.
      1 position	conj.
      1 political protection given	conj.
      1 political protection given by a	n.
      1 political protection given by a government	prep.
      1 political protection given by	ad.
      1 pleasure or	v.
      1 pleasure or	n.
      1 pleasure	conj.
      1 pleasing to	v.
      1 pleasing	prep.
      1 please come to my	n.
      1 please come to my house for	ad.
      1 please come to my house for a	conj.
      1 please come	prep.
      1 plants that are grown	conj.
      1 plants that are grown and gathered	prep.
      1 plants that are grown and gathered for	n.
      1 plants	pro.
      1 plants	conj.
      1 plants	ad.
      1 planets	conj.
      1 places or things nearby that	v.
      1 places or things nearby that have been spoken	adj.
      1 places or things nearby	pro.
      1 places or things nearby	ad.
      1 places	conj.
      1 place or thing nearby that has been spoken	adj.
      1 place or thing nearby	pro.
      1 place or thing nearby	ad.
      1 place or thing as	ad.
      1 pieces of metal or paper used to	v.
      1 pieces of metal	conj.
      1 pieces of matter so small that they	v.
      1 pieces of matter so small	pro.
      1 pieces of matter	conj.
      1 pieces of matter	ad.
      1 pictures or other	n.
      1 pictures or	ad.
      1 pictures	conj.
      1 person or group	prep.
      1 person or group for	ad.
      1 person	conj.
      1 people with little	conj.
      1 people with	ad.
      1 people	prep.
      1 people connected	conj.
      1 parts	prep.
      1 parts of cells that	v.
      1 parts of cells that control the growth	conj.
      1 parts of cells	pro.
      1 parts of cells	ad.
      1 parts away	prep.
      1 parts away from the	n.
      1 parts away from	pro.
      1 parts	ad.
      1 part of the internet that	v.
      1 part of the internet	ad.
      1 part of	pro.
      1 part of	ad.
      1 part of a company's earnings	pro.
      1 papers	conj.
      1 papers and other things sent through an	n.
      1 papers and other things sent	prep.
      1 papers and	ad.
      1 other scientists are debating his theory	adj.
      1 other scientists are debating his theory about the disappearance	prep.
      1 other scientists are debating his theory about	pro.
      1 other scientists are debating his	n.
      1 other people being spoken	adj.
      1 other	n.
      1 other	conj.
      1 or	v.
      1 or to	v.
      1 or the honoring	prep.
      1 or	pro.
      1 or listening	prep.
      1 or level	prep.
      1 or level of	ad.
      1 or groups	prep.
      1 or groups in a	n.
      1 or groups in	ad.
      1 organization	conj.
      1 or for the	n.
      1 or for	pro.
      1 or broadcast	prep.
      1 or a similar substance made	prep.
      1 or a similar	n.
      1 opposite	prep.
      1 opposed	prep.
      1 on the side that is toward the west	conj.
      1 on the side that is toward the east	conj.
      1 one who usually supports tradition	conj.
      1 one who usually supports tradition and opposes great	v.
      1 one who usually supports tradition and opposes	ad.
      1 one who usually supports social progress or	v.
      1 one who usually supports social progress	conj.
      1 one who usually supports social	n.
      1 one who usually supports	n.
      1 one who usually supports	ad.
      1 one who shows the	n.
      1 one who seeks	v.
      1 one who seeks change	prep.
      1 one who represents	ad.
      1 one who opposes or fights against the	n.
      1 one who opposes or fights against the government	prep.
      1 one who opposes or fights	ad.
      1 one who opposes	conj.
      1 one who guides or flies an	n.
      1 one who guides or flies	ad.
      1 one who guides	conj.
      1 on every	n.
      1 one time	ad.
      1 one's	v.
      1 one's job	conj.
      1 one sent to	v.
      1 one sent to act for	ad.
      1 one sent	prep.
      1 one or more	prep.
      1 one or more of no special	n.
      1 one or more connected sounds that	v.
      1 one or more connected sounds that	n.
      1 one or more connected sounds that form a single part	prep.
      1 one or more connected sounds	pro.
      1 one of two	ad.
      1 one of the twelve periods of time into which	ad.
      1 one of the twelve periods of	n.
      1 one of the sixty equal parts of an	n.
      1 one of the sixty	ad.
      1 one of the major groups that humans	v.
      1 one of the major groups that humans	n.
      1 one of the four periods of the year	ad.
      1 one of the four periods of the	n.
      1 one of the	ad.
      1 one of more than 100 substances known to science that cannot	v.
      1 one of more than 100 substances known to science	pro.
      1 one of more than 100 substances known to	n.
      1 one of more	conj.
      1 one of a series of actions designed to	v.
      1 on condition	pro.
      1 on condition	ad.
      1 on	ad.
      1 of time	ad.
      1 of this or that	n.
      1 of this or	ad.
      1 of this	conj.
      1 of the whole	n.
      1 of the	v.
      1 of the same	n.
      1 of the same kind	conj.
      1 of the present	conj.
      1 often with	v.
      1 often with	n.
      1 often used	prep.
      1 often used in	n.
      1 often to	v.
      1 often to move	pro.
      1 often to move it to another	n.
      1 often so small	pro.
      1 often so small it	v.
      1 often so small it	n.
      1 often so small it can be seen only	prep.
      1 often caused	conj.
      1 often by	v.
      1 often by the	v.
      1 often by the use	prep.
      1 often by the use of	n.
      1 often by	pro.
      1 often by	n.
      1 of or in agreement with the	n.
      1 of or in agreement with	pro.
      1 of or having to	v.
      1 of or having to do with a national or central	n.
      1 of or having to do with	ad.
      1 of or having many parts that are difficult to	v.
      1 of or having many parts	pro.
      1 of or concerning people belonging to a large group because of their	v.
      1 of or concerning people belonging to	ad.
      1 of or concerning	n.
      1 of or belonging to	pro.
      1 of or about weapons that	v.
      1 of or about weapons that explode by using	n.
      1 of or about weapons	pro.
      1 of or about weapons	ad.
      1 of or about the system that includes the	v.
      1 of or about the system	ad.
      1 of or about the energy produced by splitting atoms or bringing them	ad.
      1 of or about people or	ad.
      1 of or about more than one	n.
      1 of or about a very special	n.
      1 of or about a person or group	pro.
      1 of or about an	n.
      1 of or about a	n.
      1 of or about all the	n.
      1 of or about all	pro.
      1 of great amount or	v.
      1 of great amount	conj.
      1 offered	conj.
      1 of bad	n.
      1 of another	n.
      1 of an	n.
      1 of an amount	conj.
      1 of a different or unusual	n.
      1 of a different	conj.
      1 not young	conj.
      1 not together	conj.
      1 not through some other person	conj.
      1 not through some other	n.
      1 not tall	conj.
      1 not supporting one side or the other	prep.
      1 not supporting one side or the other in a	v.
      1 not supporting one side or	pro.
      1 not supporting one side	conj.
      1 not supporting one	n.
      1 not rough	conj.
      1 not responsible	prep.
      1 not	pro.
      1 not one	pro.
      1 not one or the other	prep.
      1 not one or	pro.
      1 not one	conj.
      1 not made	n.
      1 not long after the	v.
      1 not long after the	n.
      1 not long after	pro.
      1 not limited	conj.
      1 not later	conj.
      1 not known	prep.
      1 not just one	prep.
      1 not in the	v.
      1 not in the	n.
      1 not in the form of a liquid	conj.
      1 not in	pro.
      1 not in	n.
      1 not in good	n.
      1 not influenced	conj.
      1 not high	conj.
      1 not having	conj.
      1 not hard to	v.
      1 not hard	prep.
      1 not guilty	prep.
      1 not guilty of a	n.
      1 not from one's	v.
      1 not from one's own place	conj.
      1 not from one's own	n.
      1 not for	n.
      1 not for general	v.
      1 not flat	conj.
      1 not fast	prep.
      1 not existing	prep.
      1 not easy to	v.
      1 not easy	prep.
      1 not easily	v.
      1 not easily moved	conj.
      1 not easily cut	conj.
      1 not difficult	conj.
      1 not controlled	conj.
      1 not	conj.
      1 not all stocks	v.
      1 not all	prep.
      1 not agreeing	prep.
      1 not	adj.
      1 north is the opposite direction	prep.
      1 north is the	ad.
      1 north is	pro.
      1 no	n.
      1 no more	conj.
      1 next	prep.
      1 newly made	conj.
      1 needing	v.
      1 needing sleep or	n.
      1 needing sleep	conj.
      1 needing much	n.
      1 needing much effort or	v.
      1 needing much effort	conj.
      1 needing an immediate decision	conj.
      1 needed to	v.
      1 needed to get a result	conj.
      1 needed to get a	n.
      1 needed to get	ad.
      1 needed	prep.
      1 needed	conj.
      1 near the	v.
      1 near the	n.
      1 near	pro.
      1 near	prep.
      1 near or	prep.
      1 near	conj.
      1 navy or air	v.
      1 navy	conj.
      1 nation	conj.
      1 my sister is taller	conj.
      1 my	n.
      1 moving or working	prep.
      1 moving or working at great	v.
      1 moving or working at great	n.
      1 moving or working at	ad.
      1 moving	conj.
      1 movement	prep.
      1 movement forward or	prep.
      1 movement forward	conj.
      1 movement	ad.
      1 mostly nitrogen	conj.
      1 most human cells	v.
      1 more	v.
      1 more than	pro.
      1 more than one	n.
      1 more pay or	prep.
      1 more pay	conj.
      1 more good	conj.
      1 more bad	conj.
      1 month	conj.
      1 money received	prep.
      1 money received for	v.
      1 money paid	prep.
      1 money paid for the	v.
      1 money paid for	pro.
      1 money or property used to	v.
      1 money or property used to create	ad.
      1 money or property used	prep.
      1 money or other things	prep.
      1 money or	ad.
      1 money gained	prep.
      1 money gained from	ad.
      1 money gained from a business activity after paying all costs of	pro.
      1 money borrowed that usually	v.
      1 money borrowed that usually must be returned	prep.
      1 money borrowed	pro.
      1 money borrowed	ad.
      1 military power	prep.
      1 military organizations such	conj.
      1 mentally	ad.
      1 members of the same	n.
      1 members of the	ad.
      1 members of that	n.
      1 members of	ad.
      1 melted rock	conj.
      1 melted rock and ash into	pro.
      1 melted	n.
      1 measuring	prep.
      1 measuring from beginning to	v.
      1 measuring from beginning to	n.
      1 measuring	ad.
      1 measures necessary to	v.
      1 measures necessary to protect a person	conj.
      1 measures necessary to protect a	n.
      1 measures necessary	prep.
      1 measures	ad.
      1 may i go? they may leave	n.
      1 may i go?	pro.
      1 matter	conj.
      1 material or facts that	v.
      1 material or facts	pro.
      1 material or facts	ad.
      1 material	conj.
      1 making	ad.
      1 make or carry	ad.
      1 make	conj.
      1 magazines	conj.
      1 magazines and	ad.
      1 made to	v.
      1 made to show how something will look	conj.
      1 made to show	ad.
      1 made to	n.
      1 made	conj.
      1 lower	conj.
      1 look	prep.
      1 living things that are one	n.
      1 living things that are one cell	conj.
      1 living things that are one cell and	v.
      1 living things that are one cell and can be seen only	prep.
      1 living things	pro.
      1 living things	ad.
      1 living	n.
      1 living	conj.
      1 living and growing	prep.
      1 living and growing in	ad.
      1 little	prep.
      1 little in size	conj.
      1 little in	n.
      1 liquid	conj.
      1 links	conj.
      1 limited	prep.
      1 limited in size	conj.
      1 limited in	n.
      1 like something else	conj.
      1 like something else but not exactly	pro.
      1 liked more	conj.
      1 liked	conj.
      1 liked by many	n.
      1 liked by	ad.
      1 liked	ad.
      1 like another	conj.
      1 like a bird	conj.
      1 light produced	conj.
      1 light produced by electricity	prep.
      1 light produced by electricity in	pro.
      1 light material that rises when filled	prep.
      1 light material that rises	conj.
      1 light material	pro.
      1 light	conj.
      1 lie down or sleep	prep.
      1 lie down	conj.
      1 lie	ad.
      1 less	conj.
      1 learning	conj.
      1 leading	prep.
      1 lasting	prep.
      1 lasting only	prep.
      1 lasting only for a small	n.
      1 lasting only a short	n.
      1 lasting for a very long time	conj.
      1 lasting for a very long	n.
      1 lasting for	ad.
      1 larger than a	n.
      1 larger than	ad.
      1 larger	conj.
      1 land used to grow crops	conj.
      1 land used	prep.
      1 land	prep.
      1 land on	pro.
      1 land controlled	conj.
      1 land controlled by	ad.
      1 land away	prep.
      1 land	ad.
      1 lake or ocean onto	v.
      1 lake	conj.
      1 lacking	n.
      1 lacking money	conj.
      1 known very well	prep.
      1 known very	n.
      1 known only	prep.
      1 known	adj.
      1 known about or seen	prep.
      1 known about	conj.
      1 knowledge or ideas	prep.
      1 knowledge or ideas in making	ad.
      1 knowledge	conj.
      1 kind emotion	prep.
      1 kind emotion for someone	conj.
      1 killed or made to	v.
      1 killed or made	prep.
      1 killed	conj.
      1 keeping	v.
      1 keeping	n.
      1 job	conj.
      1 jewels or other things	prep.
      1 jewels or other things of great	n.
      1 jewels or	ad.
      1 jewels	conj.
      1 i will go if	pro.
      1 i will go	conj.
      1 i will	ad.
      1 i was	v.
      1 i was present	prep.
      1 i was	n.
      1 i was	ad.
      1 i want to thank	pro.
      1 i want	prep.
      1 it	v.
      1 it produces changes	prep.
      1 it produces changes in	ad.
      1 it may not be a good	n.
      1 it may not be a good idea to eat	conj.
      1 it may not be a good idea	prep.
      1 it may	ad.
      1 it is their right to	v.
      1 it is their right	prep.
      1 it is their	n.
      1 it is their	ad.
      1 it is supposed to	n.
      1 it is supposed	prep.
      1 it is a	n.
      1 it is a message	prep.
      1 it is	ad.
      1 it exports more	conj.
      1 it exports	ad.
      1 i suppose you are	n.
      1 i suppose you are	ad.
      1 i suppose	pro.
      1 i studied hard when i was	prep.
      1 i studied hard when i was in	n.
      1 i studied hard	conj.
      1 i studied	ad.
      1 i speak	prep.
      1 i speak for all	n.
      1 i speak for	ad.
      1 iron made harder	conj.
      1 iron made harder and stronger by mixing	pro.
      1 iron made harder and stronger by mixing it with	ad.
      1 iron made harder and stronger by mixing it	prep.
      1 in what	n.
      1 in violation of a	n.
      1 in violation of	ad.
      1 investments	conj.
      1 into or	prep.
      1 into	conj.
      1 in the	v.
      1 in the time to	v.
      1 in the space or time	ad.
      1 in the space	conj.
      1 in the same way	conj.
      1 in the same	n.
      1 in the early years of	n.
      1 in that	v.
      1 in that place	conj.
      1 in that	n.
      1 in such a way	pro.
      1 in such a	n.
      1 in or on every	n.
      1 in or on	ad.
      1 in or	n.
      1 in order	pro.
      1 in order	ad.
      1 in or at a higher	n.
      1 in or at	ad.
      1 in or	ad.
      1 in one	n.
      1 in my	n.
      1 injury or	v.
      1 injury or	n.
      1 injury	conj.
      1 injure	conj.
      1 in good	n.
      1 information gathered and stored	prep.
      1 information gathered and stored in	ad.
      1 information gathered and stored in a computer in a systematic way so computers	v.
      1 information gathered and stored in a computer in a systematic way so computers can search	pro.
      1 information	adj.
      1 information about	ad.
      1 industry	conj.
      1 industry and	v.
      1 industrial or	ad.
      1 industrial	conj.
      1 including the speaker	conj.
      1 including strong winds	conj.
      1 including strong winds and	n.
      1 including	pro.
      1 including planets	conj.
      1 including	ad.
      1 included	ad.
      1 in a way that is good	conj.
      1 in a way	pro.
      1 in at one	v.
      1 in at one	n.
      1 in at one end	conj.
      1 in at one end and out at	pro.
      1 in at one end and	ad.
      1 in a low	v.
      1 in a low	n.
      1 in agreement with the	n.
      1 in agreement with	pro.
      1 important	conj.
      1 importance or	n.
      1 importance	conj.
      1 immediately	prep.
      1 i have known her since we went to school	ad.
      1 i have known her since we went to	n.
      1 i have known her since	pro.
      1 i have known her	prep.
      1 i gave them a	v.
      1 i gave them a present	prep.
      1 i gave them a	n.
      1 i gave them	ad.
      1 i gave	pro.
      1 if	pro.
      1 if it	v.
      1 if it be the case or	n.
      1 if it be the case or fact	ad.
      1 i do not know why	pro.
      1 i do not know	conj.
      1 i do	ad.
      1 ideas or	n.
      1 ideas or information used to	v.
      1 ideas or information used	prep.
      1 ideas	conj.
      1 ice cream was her	ad.
      1 i cannot	v.
      1 i cannot tell you	adj.
      1 i cannot tell you about it	conj.
      1 i cannot tell you about it	ad.
      1 i cannot tell	pro.
      1 i am	conj.
      1 i am	ad.
      1 hurt	conj.
      1 humans or animals	v.
      1 humans	conj.
      1 how they	v.
      1 how they act	prep.
      1 how	pro.
      1 how old a person	conj.
      1 how old a	n.
      1 house	prep.
      1 higher	conj.
      1 hidden	prep.
      1 he was	prep.
      1 he was in	v.
      1 he was in	n.
      1 he was in contact with animals	ad.
      1 he was	ad.
      1 he was accused	prep.
      1 he was accused of	n.
      1 he was accused of discrimination	ad.
      1 he wants to	v.
      1 he wants to know	ad.
      1 he wants	prep.
      1 he wanted to	v.
      1 he wanted to	n.
      1 he wanted to contact his	ad.
      1 he wanted	prep.
      1 he spends much	n.
      1 he spends	ad.
      1 he served two terms	prep.
      1 he said he would write	prep.
      1 he said he would	v.
      1 her research was based	prep.
      1 he received many honors	prep.
      1 he received many honors for his efforts to	v.
      1 he received many honors for his efforts to	n.
      1 he received	ad.
      1 her company deals	prep.
      1 help me	prep.
      1 help me for	ad.
      1 he left just	conj.
      1 he left just as i came	prep.
      1 held	conj.
      1 he is suffering	prep.
      1 he is suffering from	n.
      1 he is responsible	prep.
      1 he is responsible for preparing the	v.
      1 he is responsible for preparing the	n.
      1 he is	prep.
      1 he is famous	prep.
      1 he is famous for his	v.
      1 he is famous for his	n.
      1 he is a prison	v.
      1 he is a	n.
      1 he held the	n.
      1 he held the flag so all could	v.
      1 he held the flag	conj.
      1 he held the flag	ad.
      1 he had a	v.
      1 he had a	n.
      1 he had	ad.
      1 he guards the	n.
      1 he fixed it with a	n.
      1 he fixed it with	ad.
      1 he fixed it	prep.
      1 he feared falling	ad.
      1 he directed me to the	n.
      1 he directed me	prep.
      1 he did not	v.
      1 he did not know whether he was	n.
      1 he did not know	conj.
      1 he did	ad.
      1 he	conj.
      1 heat or	ad.
      1 heat	conj.
      1 he and i will go	ad.
      1 he and i	v.
      1 health	conj.
      1 he admitted	ad.
      1 he acted to	v.
      1 he acted	prep.
      1 having	v.
      1 having to	v.
      1 having the	v.
      1 having the shape	prep.
      1 having the shape of	ad.
      1 having the shape of a ball	conj.
      1 having the power to	v.
      1 having the power	prep.
      1 having the color like that of milk	conj.
      1 having the color like that of growing leaves	conj.
      1 having the color like that of gold	conj.
      1 having the	ad.
      1 having	prep.
      1 having plenty	prep.
      1 having or feeling some	v.
      1 having or feeling some	n.
      1 having or feeling great	v.
      1 having or feeling great	n.
      1 having or feeling great coolness or a low	n.
      1 having no	v.
      1 having no	n.
      1 having much money	conj.
      1 having much knowledge	conj.
      1 having many parts	v.
      1 having lived or existed	prep.
      1 having lived or existed for	ad.
      1 having lived	conj.
      1 having little	n.
      1 having less strength	prep.
      1 having less strength because of work	conj.
      1 having less strength because of	v.
      1 having less strength because of	n.
      1 having fear	conj.
      1 having done something wrong or	prep.
      1 having done something wrong or in violation of a	n.
      1 having done something wrong	conj.
      1 having done something	ad.
      1 having a thin	n.
      1 having a thin edge or small	v.
      1 having a thin edge or small point	pro.
      1 having a thin edge	conj.
      1 having a strong	n.
      1 having a small	n.
      1 having a short	n.
      1 having a short distance	prep.
      1 having a short distance from one side to	pro.
      1 having an uneven	n.
      1 having a large	n.
      1 having a hard	v.
      1 having a hard shape	prep.
      1 having a hard	n.
      1 having a great	n.
      1 having a great distance	prep.
      1 having a great distance from one side to	pro.
      1 having a duty or job to	v.
      1 having a duty or job	prep.
      1 having a duty	conj.
      1 have	pro.
      1 hard to	v.
      1 hard	prep.
      1 hard	n.
      1 hard metal used to	v.
      1 hard metal used to make machines	conj.
      1 hard metal used	prep.
      1 groups or nations joined	ad.
      1 groups	conj.
      1 greatly honored	prep.
      1 greatly honored in	n.
      1 greatest	prep.
      1 greatest in size	conj.
      1 greatest in	n.
      1 greater	prep.
      1 greater in size	conj.
      1 greater in	n.
      1 government	conj.
      1 good feelings	prep.
      1 going	ad.
      1 goal or	ad.
      1 goal	conj.
      1 giving the	v.
      1 giving the last	prep.
      1 giving the	ad.
      1 giving	pro.
      1 giving much	n.
      1 giving another	prep.
      1 given to or owned by a single	n.
      1 given to or owned by	ad.
      1 given to	conj.
      1 given	prep.
      1 give me one	n.
      1 give me one dollar	prep.
      1 give me one dollar for	pro.
      1 give	conj.
      1 germs or	n.
      1 germs	conj.
      1 genes	v.
      1 genes	prep.
      1 genes from the mother	conj.
      1 genes from	pro.
      1 generally	prep.
      1 generally for a	n.
      1 generally for	ad.
      1 generally approved	conj.
      1 generally approved by the	ad.
      1 generally approved by	pro.
      1 gas or oil	v.
      1 gas	conj.
      1 full	prep.
      1 full of sound	conj.
      1 full of	n.
      1 fruits	conj.
      1 frozen	n.
      1 from top to	ad.
      1 from sunrise until	n.
      1 from sunrise	conj.
      1 from one to the	ad.
      1 from one to	pro.
      1 from front to	ad.
      1 from a time in the past	conj.
      1 from a time in	pro.
      1 from a	n.
      1 from	ad.
      1 free from	n.
      1 free from dirt	conj.
      1 free from anything that is different or that reduces	n.
      1 free from anything that is different	conj.
      1 free from anything	pro.
      1 freedom	prep.
      1 freedom from danger or	v.
      1 freedom from danger	conj.
      1 for what	v.
      1 for what	n.
      1 for what cause	conj.
      1 for the reason	ad.
      1 for much	n.
      1 form	conj.
      1 for enjoyment or	n.
      1 for enjoyment	conj.
      1 foreign	n.
      1 force or energy used	prep.
      1 force	conj.
      1 food	prep.
      1 food from trees	conj.
      1 food eaten to	v.
      1 food eaten	prep.
      1 flat	n.
      1 flat material made	prep.
      1 flat material made from plants	conj.
      1 fish	conj.
      1 fighting or	n.
      1 fighting	conj.
      1 fighting	ad.
      1 fight	conj.
      1 few	prep.
      1 few in	n.
      1 feeling	v.
      1 feeling part	prep.
      1 feeling part of	ad.
      1 fear	conj.
      1 fast-moving waves	prep.
      1 fast-moving waves of	n.
      1 fast-moving waves of energy that	v.
      1 fast-moving waves of energy that affect the ear	conj.
      1 fast-moving waves of energy	pro.
      1 fast-moving waves of energy	ad.
      1 far greater or better than the usual or	n.
      1 far greater or better than	pro.
      1 far greater	conj.
      1 far above the	n.
      1 far above	pro.
      1 fair	conj.
      1 extreme	v.
      1 extreme	n.
      1 extremely small pieces	prep.
      1 extremely small pieces of crushed rock found in large amounts in deserts	conj.
      1 extremely small pieces of crushed	n.
      1 express	n.
      1 expressions	conj.
      1 express concern	adj.
      1 expecting to	v.
      1 expecting to give birth to a	n.
      1 expecting to give birth to	ad.
      1 expecting	prep.
      1 expected or	ad.
      1 expected	conj.
      1 except if	pro.
      1 except	conj.
      1 exactly the other	n.
      1 exactly the	ad.
      1 exactly	pro.
      1 evidence that something exists or	v.
      1 evidence that something exists	conj.
      1 evidence	pro.
      1 evidence	prep.
      1 evidence of ownership	pro.
      1 evidence of ownership	ad.
      1 evidence	ad.
      1 every one	conj.
      1 every	n.
      1 events or processes	ad.
      1 events	conj.
      1 event or idea that is being spoken	adj.
      1 event or idea	pro.
      1 event or idea	ad.
      1 even though the	n.
      1 even though	pro.
      1 event	conj.
      1 even if	pro.
      1 especially with	n.
      1 especially when not asked to	v.
      1 especially when not asked	prep.
      1 especially the beginning	prep.
      1 especially the beginning of the	n.
      1 especially something	prep.
      1 especially one with	v.
      1 especially one	prep.
      1 especially of	n.
      1 especially how	pro.
      1 especially from the	v.
      1 especially from the	n.
      1 especially from	pro.
      1 especially by an	n.
      1 especially at the	v.
      1 especially at the	n.
      1 especially at	pro.
      1 especially as reported by the	n.
      1 especially as reported by	pro.
      1 especially anything	prep.
      1 enjoy or express what makes	n.
      1 enjoy or express	pro.
      1 enjoy or express	ad.
      1 enjoy	conj.
      1 energy from	pro.
      1 energy from	ad.
      1 ended	conj.
      1 emotions	conj.
      1 emotions and	n.
      1 emotions and body activity	prep.
      1 emotions and body activity of	ad.
      1 elements found	prep.
      1 elements found in nature	conj.
      1 elements found in	n.
      1 electronic	n.
      1 electronic mail that is sent	conj.
      1 electronic mail	pro.
      1 electronic mail	ad.
      1 electronic instructions given to computers	conj.
      1 electronic instructions given to computers and devices connected to	pro.
      1 electronic instructions given	prep.
      1 electric power companies are	v.
      1 electric power companies are seeking	prep.
      1 electric	n.
      1 election or	n.
      1 election	conj.
      1 either the right or left half	prep.
      1 either the right	conj.
      1 either the male or female group into which all people and animals are divided	prep.
      1 either the male	conj.
      1 either real	conj.
      1 economics or	n.
      1 economics	conj.
      1 economic	conj.
      1 economic and social rights given equally to all	n.
      1 economic and social rights given equally	prep.
      1 economic and	ad.
      1 easy to understand	conj.
      1 easy to see	conj.
      1 earth	prep.
      1 earth is	ad.
      1 earth in which plants	v.
      1 earth in	pro.
      1 earth	conj.
      1 ear or	n.
      1 earlier	prep.
      1 earlier in	n.
      1 ear	conj.
      1 during or	prep.
      1 during or at the	n.
      1 during or at	pro.
      1 during	conj.
      1 dry	n.
      1 drive or ride easily	prep.
      1 drive or ride easily from one place to the	ad.
      1 drive or ride easily from one place to	pro.
      1 drive or ride easily from one	n.
      1 drive	conj.
      1 done or carried out quickly or	prep.
      1 done or carried	ad.
      1 done	conj.
      1 difficulty	conj.
      1 difficult to	v.
      1 difficult to do	conj.
      1 difficult	prep.
      1 different	conj.
      1 describing areas away	prep.
      1 describing areas away from cities which	v.
      1 describing areas away from cities	pro.
      1 describing areas	ad.
      1 death or	v.
      1 death or	n.
      1 death	conj.
      1 days	conj.
      1 danger	conj.
      1 dance or sing	prep.
      1 dance	conj.
      1 criminals	v.
      1 covered with water or	ad.
      1 covered with water	conj.
      1 covered with	n.
      1 covered	prep.
      1 country or	v.
      1 country	conj.
      1 correct	prep.
      1 correct in every	n.
      1 continuing	prep.
      1 continuing in one	n.
      1 containing	conj.
      1 containing as much as a person or thing	v.
      1 containing as much as a	n.
      1 containing as	ad.
      1 contained	conj.
      1 connecting word used to	v.
      1 connecting word used to link things	pro.
      1 connecting word used to link things	ad.
      1 connecting word used	prep.
      1 connecting	n.
      1 connected	prep.
      1 connected	conj.
      1 conditions	conj.
      1 conditions and influences that	v.
      1 conditions and influences that affect	n.
      1 conditions and influences	pro.
      1 conditions and influences	ad.
      1 condition	conj.
      1 condition	ad.
      1 concerning what is right or wrong	prep.
      1 concerning what is right	conj.
      1 concerning what is	n.
      1 concerning	pro.
      1 concerning	ad.
      1 computer or	ad.
      1 computer	conj.
      1 complete or	v.
      1 complete or correct	prep.
      1 complete or correct in every	n.
      1 completely right	conj.
      1 completely	n.
      1 completely different	prep.
      1 complete	conj.
      1 common to its	n.
      1 common	prep.
      1 coming	prep.
      1 coming immediately	ad.
      1 coming before	ad.
      1 coming	ad.
      1 come early so we	n.
      1 come early so	pro.
      1 come early	conj.
      1 come	ad.
      1 colorless	n.
      1 cloth	conj.
      1 close to the	n.
      1 close to	pro.
      1 close or careful observing	prep.
      1 close	conj.
      1 clear	n.
      1 clear material	pro.
      1 clean	n.
      1 causing terror or	v.
      1 causing terror	conj.
      1 causing much	n.
      1 causing hurt or	n.
      1 causing hurt	conj.
      1 causing great	v.
      1 causing great	n.
      1 carrying a	n.
      1 carrying	ad.
      1 carrying a child within the body	prep.
      1 carrying a child within the body before it is	v.
      1 carrying a child within	pro.
      1 can happen or is expected	prep.
      1 can happen	conj.
      1 by the	n.
      1 by	pro.
      1 buying	conj.
      1 buying and selling to	v.
      1 buying and selling to earn	n.
      1 buying and selling	prep.
      1 but which is	ad.
      1 but the two	ad.
      1 but she still wanted to	v.
      1 but she still wanted	prep.
      1 but she	ad.
      1 but	prep.
      1 but not	pro.
      1 but it	ad.
      1 but is not a	n.
      1 but is	ad.
      1 but are	ad.
      1 buildings or	n.
      1 buildings	conj.
      1 bridges	conj.
      1 bottle or	v.
      1 bottle or can used	prep.
      1 bottle	conj.
      1 boat or car who is	ad.
      1 boat or car	pro.
      1 boat	conj.
      1 between spring	conj.
      1 between autumn	conj.
      1 better or more important than others	prep.
      1 better or more important than others of the same	n.
      1 better or more important than others of	pro.
      1 better	conj.
      1 below the surface	prep.
      1 belonging to the	v.
      1 belonging to the	n.
      1 belonging to the	ad.
      1 belonging to	pro.
      1 believing	conj.
      1 being the	v.
      1 being the single one	conj.
      1 being the	n.
      1 being the cause	prep.
      1 being the	ad.
      1 being ready or having a	v.
      1 being ready or having a desire	prep.
      1 being ready	conj.
      1 being	prep.
      1 being of more than usual	n.
      1 being of more	conj.
      1 being of	ad.
      1 being	ad.
      1 baseball	n.
      1 bad treatment causing	v.
      1 bad treatment causing harm	conj.
      1 bad	n.
      1 a yearly celebration or observance	prep.
      1 a yearly celebration or observance of an	n.
      1 a yearly celebration or observance of an event	pro.
      1 a yearly celebration	conj.
      1 a wrong action	conj.
      1 a written series	prep.
      1 a written series of names	conj.
      1 a written	n.
      1 a written agreement between two	conj.
      1 a writing that shows proof or facts	adj.
      1 a writing that shows proof	conj.
      1 a writing	pro.
      1 a word used with an action word to mean permit	conj.
      1 a word used with action words to	v.
      1 a word showing that something is denied	conj.
      1 a word showing	pro.
      1 a word or words written to	v.
      1 a word or words written	prep.
      1 a word or	v.
      1 a word or sign used to show	pro.
      1 a word or sign used	prep.
      1 a word by	pro.
      1 a woman who has a child	conj.
      1 a woman	conj.
      1 a white substance found	prep.
      1 a white substance found in sea water	conj.
      1 a white substance found in sea water and in	pro.
      1 a white	n.
      1 a weapon	pro.
      1 a way	prep.
      1 away or	n.
      1 a way of measuring	pro.
      1 away from	v.
      1 away from	pro.
      1 away from	n.
      1 away from harm	conj.
      1 away	conj.
      1 a way along	pro.
      1 a wall built across a river to	v.
      1 a wall built across a river	prep.
      1 a violent	v.
      1 a violent attempt to	n.
      1 a violent attempt	prep.
      1 a violent action	conj.
      1 a violent action by a large	n.
      1 a violent action by a large group	prep.
      1 a very tall	v.
      1 a very tall plant	pro.
      1 a very tall	n.
      1 a very small piece	prep.
      1 a very small part	prep.
      1 a vehicle with wings	pro.
      1 a valued white	n.
      1 a valuable	n.
      1 at what	n.
      1 at the	v.
      1 at the same time or	v.
      1 at the same time	conj.
      1 at that	n.
      1 at some	n.
      1 a torn or broken	v.
      1 a torn or broken place	prep.
      1 a torn or broken	n.
      1 at or near	pro.
      1 a torn	conj.
      1 at or during the same	n.
      1 at or during	pro.
      1 a tool or weapon used to	v.
      1 a tool or weapon used	prep.
      1 a tool or device designed to	v.
      1 a tool or device designed	prep.
      1 atomic particles are joined together to	v.
      1 atomic particles are joined together to produce nuclear	n.
      1 atomic particles are joined together	prep.
      1 atomic particles are joined	ad.
      1 at no	n.
      1 at	n.
      1 a thought or picture	prep.
      1 a thought or picture in	pro.
      1 a thought or	n.
      1 a thought	conj.
      1 a thin piece of tissue that sends information through the body to	conj.
      1 a thin piece of tissue	pro.
      1 a thing to	v.
      1 a thing	prep.
      1 a thick	n.
      1 a thick liquid that does not	v.
      1 a thick liquid that does not mix with water	conj.
      1 a thick liquid that does not mix	prep.
      1 a thick liquid	pro.
      1 a test or trial carried out	prep.
      1 a test	conj.
      1 a temporary	v.
      1 a temporary reduction	prep.
      1 a temporary halt	prep.
      1 a temporary halt in fighting agreed to	conj.
      1 a teacher	prep.
      1 a teacher at a	n.
      1 a teacher at a college	conj.
      1 at a	v.
      1 a talk given	prep.
      1 at a higher	v.
      1 at a higher	n.
      1 a system that is formed or organized	prep.
      1 a system that is formed	conj.
      1 a system	pro.
      1 a system	prep.
      1 a sweet substance made	prep.
      1 a sweet	n.
      1 a sudden	v.
      1 a sudden	n.
      1 a sudden attack carried out	conj.
      1 a sudden attack carried out as an act	prep.
      1 a success	prep.
      1 a success in a	v.
      1 a success in a	n.
      1 a success in a fight	conj.
      1 a substance that	v.
      1 a substance that is not a solid	conj.
      1 a substance that can destroy life	conj.
      1 a substance or drug used to	v.
      1 a substance or drug used	prep.
      1 a substance made	prep.
      1 a substance made from the liquid of trees with the same	v.
      1 a substance made from	pro.
      1 a substance found	prep.
      1 a substance found in nature that is not an animal or a	v.
      1 a substance found in nature that is not an animal	conj.
      1 a substance found in nature	pro.
      1 a substance containing two	conj.
      1 a substance containing killed or weakened organisms given to a person or animal to	v.
      1 a substance containing killed or weakened organisms given	prep.
      1 a substance containing killed	conj.
      1 a substance	conj.
      1 a structure sometimes used to	v.
      1 a structure sometimes used	prep.
      1 a structure built	conj.
      1 a strong movement	prep.
      1 a strong feeling such	conj.
      1 a strong feeling such as	v.
      1 a strong feeling such as	n.
      1 a strong emotion	conj.
      1 a strong emotion against someone	conj.
      1 a strong chance	prep.
      1 a story acted	prep.
      1 a stock index measures the value	prep.
      1 a stock index measures	pro.
      1 a statement produced	conj.
      1 a statement produced by a	v.
      1 a statement produced by a	n.
      1 a statement or an	v.
      1 a statement or an order	pro.
      1 a statement or an	n.
      1 a statement in which the facts	v.
      1 a statement	conj.
      1 a spoken or written agreement to	v.
      1 a spoken or written agreement	prep.
      1 a spoken	conj.
      1 a spirit or being believed	prep.
      1 a spirit or being believed in many religions to	v.
      1 a spirit	conj.
      1 a spending	v.
      1 a spending	prep.
      1 a spending of	n.
      1 a spending	n.
      1 a special kind	prep.
      1 a special event	pro.
      1 a space	prep.
      1 a solid black substance used	conj.
      1 a solid black	n.
      1 a small	v.
      1 a small part of an atom that has an electrical	v.
      1 a small part of an atom	pro.
      1 a small object	prep.
      1 a small object in space	pro.
      1 a small number	prep.
      1 a small mass	prep.
      1 a small mass of living material that is part of all plants	conj.
      1 a small mass of living material	pro.
      1 a small hand-held	n.
      1 a small hand-held device used to	v.
      1 a small hand-held device used	prep.
      1 a sleeping	v.
      1 a sleeping	n.
      1 as is	n.
      1 as in	n.
      1 a single	n.
      1 a single cell	prep.
      1 a single cell in a female person or animal that	v.
      1 a single cell in a female person or animal	pro.
      1 a single cell in a female person	conj.
      1 a similar organization	prep.
      1 a sickness	prep.
      1 a shortage that results	conj.
      1 a shortage	pro.
      1 a sharing	prep.
      1 a sharing of feelings or emotions with another	n.
      1 a sharing of feelings	conj.
      1 as from an	n.
      1 as from	ad.
      1 a series of acts or efforts to	v.
      1 a series of acts	conj.
      1 a separate	n.
      1 a separate area within a building	prep.
      1 a sentence or word used	prep.
      1 a sentence	conj.
      1 a secret	v.
      1 a secret plan to do something wrong	conj.
      1 a secret plan	prep.
      1 a seat	prep.
      1 as called	prep.
      1 as called for by a	n.
      1 as called for by	ad.
      1 as a	v.
      1 as a flag	prep.
      1 as a flag in	pro.
      1 a ruler with complete	n.
      1 a ruler	prep.
      1 a round structure	pro.
      1 a round	n.
      1 a room or	v.
      1 a room or place where experiments	prep.
      1 a room or building where business or	v.
      1 a reproduction	prep.
      1 a reproduction of the appearance of a person	conj.
      1 a reproduction of the appearance of a	n.
      1 a reproduction of	pro.
      1 a representative	prep.
      1 a representative of an organization or	n.
      1 a representative of an organization	conj.
      1 a religious	n.
      1 a relation between two	conj.
      1 a record	prep.
      1 a reason	prep.
      1 a radio	conj.
      1 a public vehicle to	v.
      1 a public vehicle	prep.
      1 a public position to which one is elected	conj.
      1 a public position to	pro.
      1 a public position	prep.
      1 a public official who decides problems	prep.
      1 a public official	pro.
      1 a public discussion	conj.
      1 a publication	prep.
      1 a proposal or	n.
      1 a proposal	conj.
      1 a prison	prep.
      1 a prison for those waiting to	v.
      1 a prison for those waiting to be tried for a crime or for those serving sentences for crimes	pro.
      1 a prison for those waiting to be tried for a crime	conj.
      1 approved	conj.
      1 approved by the	n.
      1 approved by the government or someone	prep.
      1 approved by	pro.
      1 appoint a	n.
      1 appoint	ad.
      1 a powerful	v.
      1 a powerful	n.
      1 a powerful computer that serves a network	prep.
      1 a powerful computer that serves a network of computers	conj.
      1 a powerful computer	pro.
      1 a possible explanation	prep.
      1 a possible explanation of	conj.
      1 a possibility	prep.
      1 a possibility of winning or losing or that something	v.
      1 a possibility of winning or losing or	pro.
      1 a possibility of winning	conj.
      1 a political part	prep.
      1 a political	n.
      1 a play or story presented	prep.
      1 a plant	prep.
      1 a plant grown	prep.
      1 a plan of action to kill	conj.
      1 a planned	n.
      1 a planned effort to	v.
      1 a planned effort	prep.
      1 a place where sick	conj.
      1 a place where people go	prep.
      1 a place where people can buy	conj.
      1 a place where passengers get	prep.
      1 a place where passengers get on	conj.
      1 a place where movies are shown	conj.
      1 a place where a person is kept	conj.
      1 a place where a person is kept as punishment	prep.
      1 a place where animals are kept	prep.
      1 a place where animals are kept for the public to look at	conj.
      1 a place where animals are kept for	pro.
      1 a place where airplanes take off	conj.
      1 a place to sit or	pro.
      1 a place to sit	conj.
      1 a place that is the main point	prep.
      1 a place	pro.
      1 a place or time	prep.
      1 a place of special work	conj.
      1 a place of education that usually includes several colleges	conj.
      1 a place of education	pro.
      1 a place in	pro.
      1 a place for radio	conj.
      1 a piece of iron or other material that has a pulling	v.
      1 a piece of iron or other material	pro.
      1 a piece of iron	conj.
      1 a piece of colored cloth used to	v.
      1 a picture or story	prep.
      1 a picture or story in the mind during	v.
      1 a picture or story in	pro.
      1 a picture of the earth's surface	conj.
      1 a picture of	pro.
      1 a picture in	pro.
      1 a picture	conj.
      1 a person with strong religious or political beliefs	pro.
      1 a person with strong religious	conj.
      1 a person with special knowledge	conj.
      1 a person who travels	prep.
      1 a person who takes part	prep.
      1 a person who takes part in some activity in common with another	conj.
      1 a person who strongly disagrees with his	conj.
      1 a person who strongly disagrees	prep.
      1 a person who seeks or is nominated	prep.
      1 a person who seeks or is nominated for an office or an	v.
      1 a person who seeks	conj.
      1 a person who saw	conj.
      1 a person who saw and	v.
      1 a person who saw and can tell	adj.
      1 a person who represents his or her government	prep.
      1 a person who represents his	conj.
      1 a person who is responsible	prep.
      1 a person who is forced to	v.
      1 a person who is forced to leave his	conj.
      1 a person who is forced	prep.
      1 a person who is a member	prep.
      1 a person who is a member of a country	conj.
      1 a person who has been forced to	v.
      1 a person who has been forced	prep.
      1 a person who fights	conj.
      1 a person who fights as part	prep.
      1 a person who chooses to	v.
      1 a person who chooses	prep.
      1 a person who carries out acts	prep.
      1 a person who carries out acts of extreme violence	conj.
      1 a person who carries out acts of extreme violence as a	v.
      1 a person who arrives	prep.
      1 a person who arrives in a country to	v.
      1 a person travelling	conj.
      1 a person trained	prep.
      1 a person trained in medicine to	v.
      1 a person's working	n.
      1 a person owned	conj.
      1 a person or thing	v.
      1 a person or thing put or used	prep.
      1 a person or thing	pro.
      1 a person or people	prep.
      1 a person or people of	pro.
      1 a person or country that is next	prep.
      1 a person or country	pro.
      1 a person opposing	conj.
      1 a person one likes	conj.
      1 a person leading a meeting	conj.
      1 a person involved	prep.
      1 a person involved in sailing a boat or	v.
      1 a person involved in sailing a boat	conj.
      1 a person honored	prep.
      1 a person honored for being brave	conj.
      1 a person employed	conj.
      1 a person employed by a government to	v.
      1 a person employed by a government to get secret information	adj.
      1 a person employed by a government	prep.
      1 a person captured	conj.
      1 a person captured and held as a	v.
      1 a person captured and held as a guarantee	pro.
      1 a person believed to	v.
      1 a person believed	prep.
      1 a person being treated	conj.
      1 a person being treated by a doctor	prep.
      1 a personal web site where people write	adj.
      1 a personal web site where people write about whatever	pro.
      1 a personal web site where people	v.
      1 a personal web site where	n.
      1 a period when an event	v.
      1 a period that	v.
      1 a period that can be identified	prep.
      1 a period that can be identified in hours	conj.
      1 a period	pro.
      1 a period of time for	v.
      1 a period of reduced business	conj.
      1 a period of reduced business and economic activity during which many people	v.
      1 a period of reduced business and economic activity during	pro.
      1 a period during the year	conj.
      1 a period during	pro.
      1 a period	conj.
      1 a peaceful situation	prep.
      1 a peaceful situation in which people	v.
      1 a peaceful situation in	pro.
      1 a peaceful	n.
      1 a payment ordered	conj.
      1 a payment ordered by a	n.
      1 a payment ordered by a court to	v.
      1 a payment ordered by a court	prep.
      1 a path	prep.
      1 a path on	v.
      1 a path on land or sea or in	pro.
      1 a path on land	conj.
      1 a part that shows what the	v.
      1 a part that shows what the rest	prep.
      1 a part that shows what the rest of a thing	conj.
      1 a part	pro.
      1 a part of a	v.
      1 a part belonging	prep.
      1 any weapon that	v.
      1 any weapon that can be thrown or fired	prep.
      1 any weapon that can be thrown	conj.
      1 any weapon	pro.
      1 anything used to	v.
      1 anything used to	n.
      1 anything used to cause injury or to kill	ad.
      1 anything used to cause injury	conj.
      1 anything used	prep.
      1 anything used	conj.
      1 anything used as a	n.
      1 anything used as a medicine or	prep.
      1 anything used as	ad.
      1 anything that produces	n.
      1 anything that joins	conj.
      1 anything that is	v.
      1 anything that is put over a	n.
      1 anything that is put	conj.
      1 anything that is pleasing	conj.
      1 anything that has been badly damaged	conj.
      1 anything that can be seen	conj.
      1 anything that blocks	conj.
      1 anything owned	conj.
      1 anything owned by someone such as	v.
      1 anything owned by someone such as	n.
      1 anything owned by someone	ad.
      1 anything on or in which a person or thing	v.
      1 anything on or in which a	n.
      1 anything on or in which	ad.
      1 anything on or in	pro.
      1 anything on	conj.
      1 anything of value that	v.
      1 anything of value that can be used	conj.
      1 anything of value	pro.
      1 anything of value	ad.
      1 anything of	n.
      1 anything built	prep.
      1 anything built for	v.
      1 anything built for use	conj.
      1 anything built for use as a	n.
      1 anything built for use as	ad.
      1 any substance that	v.
      1 any substance that is not solid	conj.
      1 any substance that burns to	v.
      1 any substance that burns	prep.
      1 any substance burned to	v.
      1 any substance burned to create heat	conj.
      1 any substance burned	prep.
      1 any place or part	prep.
      1 any place or part of	pro.
      1 any place	conj.
      1 any person who is a member	prep.
      1 any person who is a member of a police	v.
      1 any person	pro.
      1 any person or	v.
      1 any person or object aimed	prep.
      1 any person	conj.
      1 any one	prep.
      1 any one of the equal parts of ownership of a	n.
      1 any one of the equal parts of ownership of a business	conj.
      1 any one of	pro.
      1 any of the seven great	v.
      1 any of the seven great	n.
      1 any of the five main divisions of this	n.
      1 any of the abilities to	v.
      1 any instrument or device designed to	v.
      1 any instrument or device designed	prep.
      1 any instrument	conj.
      1 any important large	n.
      1 any group of people or things	pro.
      1 any group of people	conj.
      1 any game or activity	prep.
      1 any game	conj.
      1 any business that produces goods	conj.
      1 any business	pro.
      1 any animal	conj.
      1 an unplanned	n.
      1 an unexpected	conj.
      1 an unexpected and dangerous	n.
      1 an underwater	v.
      1 an underwater	n.
      1 a number of similar things or events that	v.
      1 a number of similar things or events	pro.
      1 a number of similar things	conj.
      1 antibiotics are a	v.
      1 antibiotics are a	n.
      1 antibiotics are	ad.
      1 antibiotics are a cure	prep.
      1 another	n.
      1 another	conj.
      1 a note	prep.
      1 a note from one person to another person	conj.
      1 an organized or developed	n.
      1 an organized	conj.
      1 an organization that keeps	conj.
      1 an organization that keeps and lends	n.
      1 an organization that is part	prep.
      1 an organization that is	n.
      1 an organization or system that provides something	prep.
      1 an organization or system	pro.
      1 an organization or	n.
      1 an organization	conj.
      1 an order to people to stay off the streets	conj.
      1 an order to people to stay off	pro.
      1 an order	prep.
      1 an operation or series	prep.
      1 an operation or series of changes leading to a desired	v.
      1 an operation or	n.
      1 an operation	conj.
      1 an opening in a wall to	v.
      1 an opening in a wall to let in light	conj.
      1 an opening in a	n.
      1 an opening for entering or leaving a	n.
      1 an opening for entering	conj.
      1 an official statement	prep.
      1 an official statement of agreement	conj.
      1 an official piece	prep.
      1 an official piece of paper with facts written on	pro.
      1 an official government document that shows a person's identity	conj.
      1 an official government document that shows a person's identity and citizenship and permits a citizen to	v.
      1 an official government document that shows a person's identity and citizenship and permits a citizen	prep.
      1 an official government document	pro.
      1 an object placed	prep.
      1 an object placed in orbit around	pro.
      1 an issue to	v.
      1 an issue	prep.
      1 an instrument	pro.
      1 an injury to the	n.
      1 an injury to the body of a human or animal in which the skin is usually	v.
      1 an injury to the body of a human	conj.
      1 an injury to	pro.
      1 an injury	prep.
      1 an incident	prep.
      1 an important quality	prep.
      1 an important problem or subject that people are discussing or arguing	adj.
      1 an important problem or subject	pro.
      1 an important problem	conj.
      1 animals	conj.
      1 animals and other things	prep.
      1 animals and other things on	n.
      1 animals and	ad.
      1 animal or other creature usually made	prep.
      1 animal or	ad.
      1 animal hair	conj.
      1 animal hair and	ad.
      1 an idea or representation	prep.
      1 an idea or representation of something as seen by	pro.
      1 an idea	conj.
      1 an honor or prize	prep.
      1 an honor	conj.
      1 an extremely important time when something	v.
      1 an extremely important time	conj.
      1 an extremely important	n.
      1 an expression	prep.
      1 an expression of	n.
      1 an examination	prep.
      1 an examination in a	n.
      1 an examination in a court of a	v.
      1 an examination in a court of a question	conj.
      1 a newly	v.
      1 a newly born	n.
      1 an event or something	pro.
      1 an event	conj.
      1 an event causing widespread destruction or loss	prep.
      1 an event causing widespread destruction	conj.
      1 an established	v.
      1 an established set	prep.
      1 an established set of plans or goals used to develop and make decisions in	n.
      1 an established set of plans	conj.
      1 an engine	conj.
      1 an engine and the cars connected to it that	v.
      1 an engine and the cars connected	prep.
      1 an engine and	pro.
      1 an electronic	n.
      1 an electronic machine	prep.
      1 an electronic machine for storing	conj.
      1 an economic system	prep.
      1 an economic system in which the prices of things are decided	conj.
      1 an economic system in which the prices of things are decided by how many there are and how much money people are willing to	v.
      1 an economic system in	pro.
      1 an economic	n.
      1 and we will return	ad.
      1 and we	v.
      1 and	v.
      1 and the	n.
      1 and the knowledge gained	adj.
      1 and so did	pro.
      1 and	prep.
      1 and power	prep.
      1 and often	n.
      1 and making sure people	v.
      1 and making sure people obey	pro.
      1 and making sure	n.
      1 and making	ad.
      1 and how they	v.
      1 and how they	n.
      1 and how	pro.
      1 an attempt to weaken or destroy a political	n.
      1 an attempt to weaken	conj.
      1 an attempt to learn or prove	pro.
      1 an attempt to learn	conj.
      1 an attack against a person	conj.
      1 a nation or person joined	prep.
      1 a nation	conj.
      1 a narrow way	prep.
      1 a narrow	n.
      1 an army	prep.
      1 an armed	v.
      1 an armed	n.
      1 an armed force	conj.
      1 an area	prep.
      1 an area or a part	prep.
      1 an area of	v.
      1 an area	conj.
      1 an angry	v.
      1 an angry	n.
      1 an amount that is more	conj.
      1 an amount	pro.
      1 an amount of matter having no special	v.
      1 an amount of matter having no special form	conj.
      1 an agreement to	v.
      1 an agreement to pay	n.
      1 an agreement that payments will be made	prep.
      1 an agreement that payments will be made at a later	n.
      1 an agreement that payments	v.
      1 an agreement	pro.
      1 an agreement	prep.
      1 an agency	prep.
      1 an agency of	pro.
      1 an act that violates a	n.
      1 an act	pro.
      1 an act	prep.
      1 an act or series	prep.
      1 an act or	n.
      1 an activity with rules in which people or teams	v.
      1 an activity with rules in which people	conj.
      1 an activity with rules in which	n.
      1 an activity with rules in	pro.
      1 an activity	prep.
      1 an activity or	n.
      1 an activity or effort	prep.
      1 an activity or effort for the purpose of improving the body or to	v.
      1 an activity or effort for	pro.
      1 an activity	conj.
      1 an action or	n.
      1 an action or movement	pro.
      1 an action done without the	n.
      1 an action done without	pro.
      1 an action done	prep.
      1 an action	conj.
      1 an act	conj.
      1 a movement	prep.
      1 a movement from one	v.
      1 amount	prep.
      1 amount or	v.
      1 amount of value	conj.
      1 a molecule that holds the genetic information necessary	prep.
      1 a molecule	pro.
      1 a military campaign	prep.
      1 a military campaign of	v.
      1 a method of recording images	conj.
      1 a method of recording images and sound without a traditional	v.
      1 a method of organizing or doing something by following rules or a	v.
      1 a method of organizing	conj.
      1 a metal container that is fired	prep.
      1 a metal container that is fired from a large gun	conj.
      1 a metal container	pro.
      1 a message written	prep.
      1 a member	prep.
      1 a meeting	prep.
      1 a measure of how quickly	conj.
      1 a material made from chemicals that	v.
      1 a material made from chemicals that can be formed	conj.
      1 a material made from chemicals	pro.
      1 a material made from a	v.
      1 a material made from a plant of	pro.
      1 a mass of wet air that is difficult to	v.
      1 a mass of wet air	pro.
      1 a mass of gas that usually appears	conj.
      1 a mass of gas	pro.
      1 a mass of fog high in	pro.
      1 a mark or shape used	prep.
      1 a mark or	n.
      1 a mark	conj.
      1 a man who has a child	conj.
      1 a man	conj.
      1 a male with the same father	conj.
      1 a male with	pro.
      1 a male	prep.
      1 a machine without wings that	v.
      1 a machine without wings that can fly up	conj.
      1 a machine without wings	pro.
      1 a machine that uses energy to	v.
      1 a machine that uses energy to cause movement	conj.
      1 a machine that uses energy	prep.
      1 a machine that moves	conj.
      1 a machine that moves and performs	v.
      1 a machine	prep.
      1 also called a cpu	conj.
      1 also a social or economic	n.
      1 also a social	conj.
      1 a long written work	prep.
      1 a long written	v.
      1 a long written	n.
      1 a long way	prep.
      1 along the	n.
      1 along	pro.
      1 a long piece	prep.
      1 a long piece of hard ground built between two places so people	v.
      1 a long piece of hard ground built between two places	conj.
      1 along or by the side	prep.
      1 along or by the	n.
      1 along or by	pro.
      1 a long-established belief or activity	prep.
      1 a long-established belief or activity of a	n.
      1 a long-established belief	conj.
      1 along	conj.
      1 a long area	prep.
      1 a long area of	v.
      1 all the persons	prep.
      1 all the persons of a	n.
      1 all the people	prep.
      1 all the people in a	v.
      1 all the	n.
      1 all the bones	prep.
      1 all the bones of a human or other	n.
      1 all the bones of a human	conj.
      1 all that which makes one person different	prep.
      1 all that which makes one	n.
      1 all public	n.
      1 all over the	n.
      1 all over	pro.
      1 all organizations involved	prep.
      1 all or any rules made by a	n.
      1 all of	n.
      1 all of a person	conj.
      1 all of a	n.
      1 all	n.
      1 all future meetings will be held	prep.
      1 all future meetings will be held in	pro.
      1 all future meetings	v.
      1 all citizens	v.
      1 all citizens should respect the	n.
      1 all citizens should respect	pro.
      1 a living growth	prep.
      1 a living growth from the	n.
      1 a living growth from	pro.
      1 a living creature	pro.
      1 a little more	conj.
      1 a little less	conj.
      1 a line	prep.
      1 a limited period	prep.
      1 a limited period of time during which someone does a job	conj.
      1 a limited period of time during	pro.
      1 a limited	n.
      1 a legal agreement between people or groups to	v.
      1 a legal agreement between people or groups	prep.
      1 a legal agreement between people	conj.
      1 a legal agreement between	n.
      1 a large	v.
      1 a large object	prep.
      1 a large object in space	pro.
      1 a large number	prep.
      1 a large number or amount	prep.
      1 a large number of people gathered in one	v.
      1 a large number	conj.
      1 a large meeting	prep.
      1 a large meeting for a special	n.
      1 a large mass	prep.
      1 a large mass of water that forms	conj.
      1 a large mass of water	pro.
      1 a large group	prep.
      1 a large group of wild	conj.
      1 a large enough	n.
      1 a large container	prep.
      1 a large collection	prep.
      1 a large collection of	n.
      1 a large area of	v.
      1 a large area of fresh water surrounded	conj.
      1 a large area of fresh water surrounded by	v.
      1 a large animal often used	prep.
      1 a large amount of water that flows across	v.
      1 a large amount of water	pro.
      1 a land area with water all around	pro.
      1 a land area	prep.
      1 a lake	conj.
      1 a lack of sleep affected	pro.
      1 a lack of noise	conj.
      1 a kind of radiation that	v.
      1 a kind of radiation	pro.
      1 a kind of organism	pro.
      1 a job that an organization or business	v.
      1 a job that an organization or business can do	prep.
      1 a job that an organization	conj.
      1 airplanes	v.
      1 airplanes	n.
      1 airplanes land	prep.
      1 airplane	conj.
      1 a hurt or suffering somewhere	prep.
      1 a hurt or suffering somewhere in the	n.
      1 a hurt or suffering somewhere in	pro.
      1 a hurt	conj.
      1 a human or	n.
      1 a human or animal	prep.
      1 a human or animal in	pro.
      1 a human	conj.
      1 a hole	prep.
      1 a hole in	pro.
      1 a hill or mountain around a hole	prep.
      1 a hill or mountain around a hole in the earth's surface that	v.
      1 a hill or mountain around a hole in	pro.
      1 a hill	conj.
      1 a highly valued yellow	n.
      1 a heavy vehicle used to	v.
      1 a heavy vehicle used	prep.
      1 a heavy military vehicle	prep.
      1 a heating	n.
      1 a heating device used	prep.
      1 a hard substance such	conj.
      1 a hard piece	prep.
      1 a hard outside	v.
      1 a hard outside	n.
      1 a happy	n.
      1 a happy idea	adj.
      1 a happy idea about	pro.
      1 a halt	prep.
      1 a grown	n.
      1 a group organized	prep.
      1 a group of students who	v.
      1 a group of students	pro.
      1 a group of questions or problems used to	v.
      1 a group of questions	conj.
      1 a group of people living together in one	v.
      1 a group of people living together in one place	conj.
      1 a group of people given special	v.
      1 a group of people chosen to	v.
      1 a group of people chosen to decide	pro.
      1 a group of people and vehicles moving together to	v.
      1 a group of ministers that helps	v.
      1 a group of ministers	pro.
      1 a group of individuals	v.
      1 a group of individuals born	conj.
      1 a group of individuals born and living	adj.
      1 a group of individuals born and living about	pro.
      1 a group of families ruled	conj.
      1 a group of connected things	conj.
      1 a group of computers	conj.
      1 a group of cells that are similar in appearance	conj.
      1 a group of cells that are similar in appearance and	v.
      1 a group of cells	pro.
      1 agreement or	n.
      1 agreement	conj.
      1 agreeing with	pro.
      1 agreeing	prep.
      1 a great	n.
      1 a grain used to	v.
      1 a grain used	prep.
      1 a government agency responsible	prep.
      1 a government agency responsible for guarding	pro.
      1 a good	n.
      1 a good chance	prep.
      1 a good chance of taking	v.
      1 a god	conj.
      1 a goal	conj.
      1 a gathering	prep.
      1 a gathering of	n.
      1 after the	v.
      1 after the correct	n.
      1 after	pro.
      1 a form of energy that flows through wires to provide heat	conj.
      1 a form of energy that affects the eyes	conj.
      1 a food or substance	pro.
      1 a food made	prep.
      1 a food	conj.
      1 a flat	v.
      1 a flat piece	prep.
      1 a flat piece of material with writing	pro.
      1 affecting or including	ad.
      1 affecting	conj.
      1 a female with the same father	conj.
      1 a female with	pro.
      1 a female	prep.
      1 a feeling of	v.
      1 a feeling of sadness or sorrow	adj.
      1 a feeling of sadness or sorrow about something	pro.
      1 a feeling of sadness	conj.
      1 a feeling of	n.
      1 a father	conj.
      1 a farm animal used for its meat	conj.
      1 a famous	n.
      1 a family member	prep.
      1 a family member from	pro.
      1 a dry	n.
      1 a dry area	prep.
      1 a dry area of	v.
      1 admitted to	pro.
      1 admitted	prep.
      1 a dividing	n.
      1 a disease	prep.
      1 a disease in which dangerous cells	v.
      1 a disease in which dangerous cells grow quickly	conj.
      1 a disease in	pro.
      1 a difficult	v.
      1 a difficult question or situation	prep.
      1 a difficult question	conj.
      1 a difficult	n.
      1 a device with moving parts used to	v.
      1 a device used to make very small things look larger so	pro.
      1 a device used to make very small things look larger	conj.
      1 a device that uses radio signals to	v.
      1 a device that uses radio signals to learn the position	conj.
      1 a device that uses radio signals	prep.
      1 a device that receives electronic signals	conj.
      1 a device that permits a person or thing to	v.
      1 a device that permits a person or thing	prep.
      1 a device that permits a person	conj.
      1 a device that measures	conj.
      1 a device that explodes with great	v.
      1 a device that explodes	prep.
      1 a device shaped	v.
      1 a device shaped like a tube that moves through air	conj.
      1 a device shaped like a tube that moves	prep.
      1 a device shaped like a tube	pro.
      1 a device or system	prep.
      1 a device for making objects that are far away	v.
      1 a device for making objects that are far away appear closer	conj.
      1 a device for making objects	pro.
      1 a device	conj.
      1 a dead	n.
      1 added	prep.
      1 a day when one does not	v.
      1 a day	prep.
      1 a day on which no work is done to honor	conj.
      1 a day on which no	v.
      1 a day on	pro.
      1 a day	conj.
      1 a dangerous	n.
      1 activity or belief that has existed	prep.
      1 activity or belief that has existed for a long	n.
      1 activity or belief	pro.
      1 activity or belief	ad.
      1 actions taken to	v.
      1 actions taken to gain	n.
      1 actions taken to gain money or power	pro.
      1 actions taken to gain money or power	ad.
      1 actions taken to gain money	conj.
      1 actions taken	prep.
      1 acting against the	n.
      1 acting against	pro.
      1 acting	ad.
      1 a creature that lives	conj.
      1 a creature that lives and	v.
      1 a creature that lives and can breathe	prep.
      1 a covering	prep.
      1 a covering for the	n.
      1 a covering for	pro.
      1 a country's parliament	conj.
      1 a country's	n.
      1 a continuing rise	prep.
      1 a continuing rise in prices while	pro.
      1 a continuing rise in prices	n.
      1 a continuing rise in prices	conj.
      1 a continuing change	prep.
      1 a continuing change of position	conj.
      1 a continuing change of	n.
      1 a container used to	v.
      1 a container used to hold liquid	conj.
      1 a container used	prep.
      1 a connected series	prep.
      1 a connected	n.
      1 a competition	conj.
      1 a competition by opposing political candidates	v.
      1 a competition by opposing political candidates seeking support	prep.
      1 a company that operates such a road	conj.
      1 a company	pro.
      1 a communication	prep.
      1 a communication in writing sent to another	n.
      1 a common	n.
      1 a colored	n.
      1 a colored liquid used to	v.
      1 a colored liquid used to cover	conj.
      1 a colored liquid used	prep.
      1 a collection of recorded	n.
      1 a collection of	n.
      1 a collection of information prepared	conj.
      1 a collection of information prepared by a person or organization on	pro.
      1 a cloud	v.
      1 a cloud close to	pro.
      1 a cloud close	prep.
      1 a closed	v.
      1 a closed shape that has all its points equally distant	prep.
      1 a closed shape	pro.
      1 a closed	n.
      1 a city where ships	v.
      1 a city where ships load	conj.
      1 a chosen	n.
      1 a choice or decision expressed by the	n.
      1 a choice or decision expressed by	pro.
      1 a choice	conj.
      1 a chemical substance used to	v.
      1 a chemical substance used to ease pain or to affect	pro.
      1 a chemical substance used to ease pain	conj.
      1 a chemical substance used	prep.
      1 a chemical	n.
      1 a change to a better	n.
      1 a change	prep.
      1 a ceremony held	prep.
      1 a ceremony held in connection with the burial	conj.
      1 a ceremony held in connection with	pro.
      1 a center where people	v.
      1 a careful	v.
      1 a careful study to discover correct	n.
      1 a careful study	prep.
      1 a car	conj.
      1 a business that is organized	conj.
      1 a business that is organized as a legal company	v.
      1 a business that is organized as a legal company separate	prep.
      1 a business	pro.
      1 a business organized	prep.
      1 a business organized for	v.
      1 a building or group	prep.
      1 a building in which people	v.
      1 a building in	pro.
      1 a building	conj.
      1 a boy	conj.
      1 above	conj.
      1 about or	prep.
      1 about or having to do with the	n.
      1 about or having to do with	pro.
      1 about or having to do with one	n.
      1 about or from another	n.
      1 about or from	ad.
      1 about	n.
      1 a bond	v.
      1 a bond can be bought	conj.
      1 a bomb placed under the ground	conj.
      1 a bomb placed under	pro.
      1 a bomb placed	prep.
      1 a body	prep.
      1 able to use	n.
      1 able to use knowledge	conj.
      1 able to use knowledge and understanding to make	ad.
      1 a black	n.
      1 a black liquid taken	prep.
      1 a black liquid taken from the ground	conj.
      1 a black liquid taken from	pro.
      1 a belief	prep.
      1 a belief based	prep.
      1 a belief based on one's	v.
      1 a belief based on one's own ideas	conj.
      1 a bank account is a	v.
      1 a bank account is a record	prep.
      1 a bank account is a record of how much money a person	conj.
